broker_source_date,symbol,total_net_value,top_buyer,top_buyer_concentration,top_buyer_net_value,num_buyers,num_sellers,num_brokers,retail_broker_ratio
2025-09-03,AADI,-1337175000,AK,0.3788741552049005,27805372500,10,10,20,0.0
2025-09-03,AALI,492482500,CP,0.28786291568781525,1781342500,10,10,20,0.0
2025-09-03,ABBA,0,AK,0.6615288867702168,14987400,9,5,14,0.0
2025-09-03,ABMM,14742000,KK,0.35945435127684344,209013000,10,10,20,0.0
2025-09-03,ACES,-3276023400,ZP,0.20553260325883865,3366517000,10,10,20,0.0
2025-09-03,ACRO,-13453600,YP,0.3455026451556345,158040200,10,9,19,0.0
2025-09-03,ACST,101429700,YU,0.2525282754279602,707206900,10,10,20,0.0
2025-09-03,ADCP,185247500,AO,0.3624246200166531,3077623000,10,10,20,0.0
2025-09-03,ADES,0,XL,0.7781117516430767,86722500,5,5,10,0.0
2025-09-03,ADHI,1310728600,SQ,0.21498083617623825,1822810600,10,10,20,0.0
2025-09-03,ADMF,0,XL,0.34358211886159934,61237500,7,7,14,0.0
2025-09-03,ADMG,-4147400,XL,0.25864040057606036,51219800,10,10,20,0.0
2025-09-03,ADMR,837224500,CC,0.5705146640408368,7066207500,10,10,20,0.0
2025-09-03,ADRO,2127497000,SQ,0.34096765468590656,12763894000,10,10,20,0.0
2025-09-03,AEGS,-135870800,XL,0.6889858068882951,7009794100,10,10,20,0.0
2025-09-03,AGAR,0,IN,0.5348051170153596,2500000,6,7,13,0.0
2025-09-03,AGII,-1914500,PD,0.41590296495956874,73292500,10,6,16,0.0
2025-09-03,AGRO,-35139600,YP,0.19262163303820426,109987800,10,10,20,0.0
2025-09-03,AGRS,901200,CC,0.49775643873010234,61632700,10,10,20,0.0
2025-09-03,AHAP,-12828500,CC,0.48377462394404497,161184900,10,9,19,0.0
2025-09-03,AIMS,0,XC,0.39416465341014684,424200,3,2,5,0.0
2025-09-03,AISA,-45402200,CC,0.4132138857782755,170514900,10,10,20,0.0
2025-09-03,AKPI,0,YP,0.6701647795268342,3640000,5,2,7,0.0
2025-09-03,AKRA,2241528000,DP,0.24157966677421458,3646041000,10,10,20,0.0
2025-09-03,AKSI,0,XA,0.4759484673478454,5356800,9,5,14,0.0
2025-09-03,ALDO,50400,NI,0.8307406825443145,22205200,4,10,14,0.0
2025-09-03,ALII,-688000,YP,0.42592563876651984,302141000,10,7,17,0.0
2025-09-03,ALKA,0,XC,0.6040253677442086,2743000,5,5,10,0.0
2025-09-03,AMAG,0,GR,0.922797844528624,24214400,6,7,13,0.0
2025-09-03,AMAN,8208500,OD,0.29789964179478917,75521700,6,10,16,0.0
2025-09-03,AMAR,0,YP,0.4388505091574755,9541400,6,7,13,0.0
2025-09-03,AMFG,2308000,YP,0.5200341005967605,79910000,5,10,15,0.0
2025-09-03,AMIN,-133000,GR,0.24665679488503967,30083200,10,10,20,0.0
2025-09-03,AMMN,-8822797500,BK,0.24488205189147347,13353007500,10,10,20,0.0
2025-09-03,AMMS,17021300,ZP,0.7136147181895599,900995100,10,10,20,0.0
2025-09-03,AMOR,0,CC,0.6111268182349959,25073800,10,3,13,0.0
2025-09-03,AMRT,-1860874000,AK,0.40124349310989493,9715535000,10,10,20,0.0
2025-09-03,ANDI,-2159500,PD,0.31209556272653427,23705000,10,7,17,0.0
2025-09-03,ANJT,897500,CC,0.6414432034037402,1140363500,9,10,19,0.0
2025-09-03,ANTM,-21270302000,CC,0.35679877492007495,96498190000,10,10,20,0.0
2025-09-03,APEX,36641300,ZP,0.37802981824374876,555361300,10,10,20,0.0
2025-09-03,APIC,32359500,AK,0.2318918493453219,303449500,10,10,20,0.0
2025-09-03,APII,0,YP,0.9629407754756347,18646000,4,6,10,0.0
2025-09-03,APLI,0,GR,0.7627366369710468,2191800,3,4,7,0.0
2025-09-03,APLN,89169000,XL,0.47427817588087817,612252100,10,10,20,0.0
2025-09-03,ARCI,-12000982500,BB,0.22058598596678802,9131097000,10,10,20,0.0
2025-09-03,AREA,-53500,XA,0.3974830107454128,93994000,10,10,20,0.0
2025-09-03,ARGO,0,XC,0.4996860637416179,19896000,10,7,17,0.0
2025-09-03,ARII,78800,CC,0.8597716426025493,56927200,7,10,17,0.0
2025-09-03,ARKA,-8679100,XL,0.23428533332466106,72041100,10,10,20,0.0
2025-09-03,ARKO,107615000,NI,0.4692143521037403,607561500,9,10,19,0.0
2025-09-03,ARNA,-8754000,ZP,0.4335365968242037,461413000,10,7,17,0.0
2025-09-03,ARTA,0,CC,0.6995391705069124,2277000,4,4,8,0.0
2025-09-03,ARTO,-159741000,BK,0.16130705141796517,464082000,10,10,20,0.0
2025-09-03,ASBI,0,AI,0.6101455555020622,3802000,6,10,16,0.0
2025-09-03,ASDM,0,PD,0.5691699604743083,216000,2,2,4,0.0
2025-09-03,ASGR,-2844500,ZP,0.4451692676287706,150132000,10,10,20,0.0
2025-09-03,ASHA,1517100,OD,0.44801005446166736,41706600,5,10,15,0.0
2025-09-03,ASII,7297602500,ZP,0.31509114502604624,36947187500,10,10,20,0.0
2025-09-03,ASJT,0,YP,0.4274781715459682,5826100,6,7,13,0.0
2025-09-03,ASLC,-224144100,IN,0.32193415735343983,1340000000,10,10,20,0.0
2025-09-03,ASMI,0,HD,0.8782649714787443,120833100,6,9,15,0.0
2025-09-03,ASPI,-12672600,MG,0.4021725059509407,560452000,10,10,20,0.0
2025-09-03,ASRI,-73852300,AT,0.48158001241018994,1405059000,10,10,20,0.0
2025-09-03,ASRM,0,XC,0.39693084434996345,1195000,6,3,9,0.0
2025-09-03,ASSA,-416522500,AZ,0.3221495457825815,1126239000,10,10,20,0.0
2025-09-03,ATAP,0,YP,0.8058831386362939,388557200,10,9,19,0.0
2025-09-03,ATIC,223000,ZP,0.6639204828775093,139802400,8,10,18,0.0
2025-09-03,ATLA,-132698700,YP,0.36037294366495987,637513900,10,10,20,0.0
2025-09-03,AUTO,-14206000,TP,0.46897157623386404,2246228000,10,10,20,0.0
2025-09-03,AVIA,50233000,BK,0.50474354091683,4057311400,10,10,20,0.0
2025-09-03,AWAN,11722400,CC,0.7632603154125934,231214600,5,10,15,0.0
2025-09-03,AXIO,-12700,XC,0.4927941560135664,37777600,10,9,19,0.0
2025-09-03,AYAM,-723800,AT,0.9558131722728933,3283234400,10,10,20,0.0
2025-09-03,AYLS,-2033200,KK,0.28539712681098667,26211500,10,8,18,0.0
2025-09-03,BABP,52159800,AI,0.4398653238186718,416584000,10,10,20,0.0
2025-09-03,BABY,0,BK,0.8919431919516698,113625000,9,7,16,0.0
2025-09-03,BACA,-445800,XL,0.32425918404147,71210300,10,10,20,0.0
2025-09-03,BAIK,-1494300,YP,0.4179776866721427,80552200,10,10,20,0.0
2025-09-03,BAJA,-3387700,AT,0.622256593943341,91725600,10,9,19,0.0
2025-09-03,BALI,-7565000,XL,0.6129696490712564,272233000,10,6,16,0.0
2025-09-03,BANK,6852000,YU,0.2988722858183886,298577000,10,10,20,0.0
2025-09-03,BAPA,-58083600,PD,0.316098780355435,234722500,10,10,20,0.0
2025-09-03,BAPI,979000,YP,0.47482531367895536,110479600,10,10,20,0.0
2025-09-03,BATA,0,XL,0.7908694312065818,6671300,5,2,7,0.0
2025-09-03,BATR,-7992800,CC,0.26835729483416393,82348200,10,10,20,0.0
2025-09-03,BAUT,-1354500,YP,0.9276730788097687,1021208500,10,10,20,0.0
2025-09-03,BAYU,0,YP,0.770951739853653,286893500,7,7,14,0.0
2025-09-03,BBCA,-258603395000,CC,0.24738087362734398,190788665000,10,10,20,0.0
2025-09-03,BBHI,14831500,CC,0.28704860512496416,323843500,10,10,20,0.0
2025-09-03,BBKP,-251704300,YP,0.2649751744760141,949941300,10,10,20,0.0
2025-09-03,BBLD,0,CC,0.4862484420440382,2926000,6,4,10,0.0
2025-09-03,BBMD,0,XL,0.6238911886457718,1055000,2,3,5,0.0
2025-09-03,BBNI,11388706000,AK,0.31210392985469754,19763771000,10,10,20,0.0
2025-09-03,BBRI,12253411000,ZP,0.24129573110560373,40040312000,10,10,20,0.0
2025-09-03,BBRM,1886400,AZ,0.5725417259568399,287766800,10,10,20,0.0
2025-09-03,BBSI,0,LG,0.7601400781943345,31691000,2,3,5,0.0
2025-09-03,BBSS,0,CC,0.542702025475047,1039600,4,4,8,0.0
2025-09-03,BBTN,-520812500,OD,0.27863668405735914,2365300000,10,10,20,0.0
2025-09-03,BBYB,-1701269400,ZP,0.3207822616518126,3564609800,10,7,17,0.0
2025-09-03,BCAP,-39629400,BQ,0.3255219282511117,156161300,10,10,20,0.0
2025-09-03,BCIP,488200,TF,0.5357090397156249,93000000,8,10,18,0.0
2025-09-03,BDKR,-57196100,XL,0.16450624172066586,252094300,10,10,20,0.0
2025-09-03,BDMN,57644000,YP,0.5019149682756082,436267000,10,10,20,0.0
2025-09-03,BEEF,468435600,AT,0.5080878367712128,980381800,7,10,17,0.0
2025-09-03,BEER,-207100,AO,0.32594464949085705,21689400,10,8,18,0.0
2025-09-03,BEKS,-1302282500,SQ,0.23535198003071747,1208270000,10,2,12,0.0
2025-09-03,BELI,0,EP,0.43986298744850055,18363400,10,5,15,0.0
2025-09-03,BELL,126931000,CC,0.435659835098703,1160632000,10,10,20,0.0
2025-09-03,BESS,0,PG,0.7396413781140911,68226000,7,7,14,0.0
2025-09-03,BEST,-394073100,YP,0.31079262334177393,641180100,10,10,20,0.0
2025-09-03,BFIN,-1845492000,PD,0.19458876956734006,1466146500,10,9,19,0.0
2025-09-03,BGTG,-8506400,XL,0.23078908072150547,319107700,10,10,20,0.0
2025-09-03,BHAT,47418000,XA,0.3403030195794933,134630000,8,10,18,0.0
2025-09-03,BHIT,2900800,YU,0.5742830184191121,267983600,10,10,20,0.0
2025-09-03,BIKE,-105629000,SA,0.15302938664663354,420644500,10,10,20,0.0
2025-09-03,BIMA,0,CC,0.7863255305842958,9933100,2,9,11,0.0
2025-09-03,BINA,0,RS,1.0,24255000,1,5,6,0.0
2025-09-03,BINO,0,YP,0.7136547118950206,78231900,10,7,17,0.0
2025-09-03,BIPI,-731760800,XA,0.6380251020378062,4312592800,10,10,20,0.0
2025-09-03,BIPP,0,XL,0.40469363268460334,1990000,4,5,9,0.0
2025-09-03,BIRD,-6829000,XL,0.2716020381025698,315058500,10,10,20,0.0
2025-09-03,BISI,267500,XL,0.527646625150978,100914000,9,10,19,0.0
2025-09-03,BJBR,-177481500,NI,0.15609530719279818,216224000,10,8,18,0.0
2025-09-03,BJTM,-51454000,YP,0.4577529477762886,307217000,10,9,19,0.0
2025-09-03,BKDP,0,XL,0.8213580177230908,61118400,10,4,14,0.0
2025-09-03,BKSL,-408833700,IF,0.21161708038655824,1933322600,10,10,20,0.0
2025-09-03,BKSW,-1393100,YP,0.30566217489441055,61087900,10,9,19,0.0
2025-09-03,BLES,-26956200,XC,0.5163560981546503,305901900,10,10,20,0.0
2025-09-03,BLTA,-20094800,XL,0.34507373370378286,213127200,10,10,20,0.0
2025-09-03,BLUE,0,XL,0.5533924815385696,26783200,8,6,14,0.0
2025-09-03,BMAS,0,ZP,0.3129990418396678,1470000,7,5,12,0.0
2025-09-03,BMBL,6149000,DR,0.4055820777129426,122303600,8,10,18,0.0
2025-09-03,BMHS,-11487200,XL,0.1851314734435797,54535400,10,7,17,0.0
2025-09-03,BMRI,12119126000,AK,0.30358203332484435,76009225000,10,10,20,0.0
2025-09-03,BMSR,220800,XC,0.375120502458737,7704600,10,10,20,0.0
2025-09-03,BMTR,47419300,BK,0.3757656339324874,342191200,10,10,20,0.0
2025-09-03,BNBA,-2832500,BQ,0.8179892929793524,141946500,10,10,20,0.0
2025-09-03,BNBR,-332779800,EP,0.4342541232459513,818530200,10,6,16,0.0
2025-09-03,BNGA,-87541000,BK,0.42883846558642863,1203632500,10,10,20,0.0
2025-09-03,BNII,105000,CC,0.5638968358106219,31458000,8,10,18,0.0
2025-09-03,BNLI,16215000,ZP,0.8049531337224648,344627000,5,10,15,0.0
2025-09-03,BOAT,8050200,XL,0.40966289188154775,330849200,10,10,20,0.0
2025-09-03,BOBA,0,YP,0.3576676890909629,7253000,7,6,13,0.0
2025-09-03,BOGA,-1710000,BR,0.47013151593725544,80502500,10,8,18,0.0
2025-09-03,BOLA,330200,DH,0.5145870398488444,25655200,10,10,20,0.0
2025-09-03,BOLT,0,XL,1.0,107500,1,1,2,0.0
2025-09-03,BPFI,0,XA,0.7810333672243276,1690000,3,2,5,0.0
2025-09-03,BPII,-1815000,DR,0.23733162283515075,23125000,10,10,20,0.0
2025-09-03,BPTR,0,XL,0.867369150779896,12511800,5,4,9,0.0
2025-09-03,BRAM,0,EP,0.6650406504065041,1022500,2,2,4,0.0
2025-09-03,BREN,-14978855000,MG,0.2830852695016686,28944725000,10,10,20,0.0
2025-09-03,BRIS,835365000,KZ,0.6384305927362033,4937868000,10,10,20,0.0
2025-09-03,BRMS,-49089982500,YP,0.3712201713176314,45881038000,10,10,20,0.0
2025-09-03,BRNA,0,YU,0.7146718908020023,56180000,7,4,11,0.0
2025-09-03,BRPT,-14691302000,CC,0.15117920962796877,7907094000,10,10,20,0.0
2025-09-03,BSBK,410880800,XL,0.35835005314661894,3246190500,10,10,20,0.0
2025-09-03,BSDE,327502500,ZP,0.33426158377764625,5093053000,10,10,20,0.0
2025-09-03,BSIM,0,KK,0.6472919987935715,7511500,4,5,9,0.0
2025-09-03,BSML,-29391400,CP,0.7226988095685596,1663031500,10,10,20,0.0
2025-09-03,BSSR,-9495000,NI,0.5170110460682159,204725000,10,9,19,0.0
2025-09-03,BSWD,0,XC,1.0,141000,1,1,2,0.0
2025-09-03,BTEK,167112000,CC,0.4676800411862158,1062852000,10,10,20,0.0
2025-09-03,BTON,0,AI,0.7194994211367771,2610200,6,6,12,0.0
2025-09-03,BTPN,0,YP,0.47141225275055615,7841000,7,7,14,0.0
2025-09-03,BTPS,-92324500,OD,0.7222100284399701,3785639000,10,10,20,0.0
2025-09-03,BUAH,-134500,YP,0.3726523897704887,126176000,10,8,18,0.0
2025-09-03,BUDI,0,XL,0.5409249885465902,9681800,6,6,12,0.0
2025-09-03,BUKA,-804007900,ZP,0.22385234691244552,4290545900,10,10,20,0.0
2025-09-03,BUKK,0,CC,0.6593617971353004,9598000,4,6,10,0.0
2025-09-03,BULL,551718400,II,0.4320221805006057,8042287300,10,10,20,0.0
2025-09-03,BUMI,-2396039800,CP,0.3134374010665164,8228115300,10,10,20,0.0
2025-09-03,BUVA,-4667413400,YJ,0.3765474277339928,8157712200,10,10,20,0.0
2025-09-03,BVIC,-249918500,KK,0.2732652310432018,339308300,10,10,20,0.0
2025-09-03,BYAN,0,KK,0.3571639489484563,27215000,6,9,15,0.0
2025-09-03,CAKK,405700,AZ,0.7353814581608278,246895500,10,10,20,0.0
2025-09-03,CAMP,272000,AH,0.689769566182348,165340800,10,10,20,0.0
2025-09-03,CANI,0,YP,0.5501536584462777,31202900,5,7,12,0.0
2025-09-03,CARE,31430200,TP,0.5609557905064506,454652200,10,10,20,0.0
2025-09-03,CARS,-259157400,RF,0.32527360897221624,1182894300,10,10,20,0.0
2025-09-03,CASA,-30565000,AO,0.34955386686748363,268061500,10,10,20,0.0
2025-09-03,CASH,0,XL,0.6668534989565051,42593200,8,10,18,0.0
2025-09-03,CASS,-1547000,PD,0.5403492415341512,113596000,10,7,17,0.0
2025-09-03,CBPE,-53300,XL,0.5817798499958815,78398500,10,10,20,0.0
2025-09-03,CBRE,608391000,CP,0.9175407616325868,4264334000,4,10,14,0.0
2025-09-03,CBUT,0,YP,0.4964899017172481,6895500,6,4,10,0.0
2025-09-03,CCSI,143600,XL,0.5693356518690033,135089800,10,10,20,0.0
2025-09-03,CEKA,0,AT,0.46237275235467606,4860000,6,6,12,0.0
2025-09-03,CENT,22604900,KK,0.23287894901021083,269280700,10,10,20,0.0
2025-09-03,CFIN,-2581200,KK,0.5025338484041556,133990600,10,10,20,0.0
2025-09-03,CGAS,262443000,YJ,0.7390379266807355,3859298400,10,10,20,0.0
2025-09-03,CHEM,-158599300,EP,0.8386405797848593,1786180400,10,10,20,0.0
2025-09-03,CHIP,0,SF,0.27709013050570963,13588500,8,7,15,0.0
2025-09-03,CINT,-383800,XL,0.42057378691207054,23723600,10,10,20,0.0
2025-09-03,CITA,-16117000,XL,0.24623705581055655,203641000,10,8,18,0.0
2025-09-03,CITY,-5500,AZ,0.7372611042097591,99944000,10,9,19,0.0
2025-09-03,CLAY,0,AZ,0.37037418080432927,18000000,7,2,9,0.0
2025-09-03,CLEO,-272078000,CC,0.1989624643393102,365062000,10,10,20,0.0
2025-09-03,CLPI,0,XL,0.44705530852914815,38155500,10,4,14,0.0
2025-09-03,CMNP,135500,XL,0.6743652390889445,45404000,7,10,17,0.0
2025-09-03,CMNT,-225128500,AK,0.46465113924523277,2588394000,10,10,20,0.0
2025-09-03,CMPP,0,GR,0.7912362492615713,19823000,4,8,12,0.0
2025-09-03,CMRY,114002000,KZ,0.7945878337838795,2973153000,10,10,20,0.0
2025-09-03,CNKO,-74126900,CC,0.23670839617372952,314796200,10,10,20,0.0
2025-09-03,CNMA,15876300,PD,0.7115293008706718,1027513700,10,10,20,0.0
2025-09-03,COAL,18697900,CC,0.40043793848568254,354007600,10,10,20,0.0
2025-09-03,COCO,-90397500,XL,0.3186833076504327,1493969500,10,10,20,0.0
2025-09-03,CPIN,2141653000,PD,0.37768839115370756,7089548000,10,10,20,0.0
2025-09-03,CPRO,-1409265500,YP,0.29157230839175596,2503086600,10,10,20,0.0
2025-09-03,CRAB,0,EP,0.995285545912354,124472600,2,6,8,0.0
2025-09-03,CRSN,0,XC,0.8260202407530126,25677500,8,7,15,0.0
2025-09-03,CSAP,0,YP,0.45755865835575443,13639000,6,7,13,0.0
2025-09-03,CSIS,0,XL,0.24528569283486049,14538500,8,5,13,0.0
2025-09-03,CSMI,0,XL,0.36403189342158654,69077600,8,5,13,0.0
2025-09-03,CSRA,609500,NI,0.3678881562059048,225001500,10,10,20,0.0
2025-09-03,CTRA,-3157331500,YU,0.2943811675680332,4244719000,10,9,19,0.0
2025-09-03,CTTH,0,XL,0.6912751677852349,2163000,4,8,12,0.0
2025-09-03,CUAN,762023500,BK,0.3683317953925724,11508417000,10,10,20,0.0
2025-09-03,CYBR,-103572000,TP,0.34877463414634147,1161855500,10,10,20,0.0
2025-09-03,DAAZ,-308000,YP,0.24755913667311472,65012000,10,10,20,0.0
2025-09-03,DADA,2234700,CP,0.5515285326086956,126648600,7,10,17,0.0
2025-09-03,DART,0,SQ,0.8899596934868959,133781500,7,8,15,0.0
2025-09-03,DAYA,0,XC,0.8693965517241379,2017000,4,5,9,0.0
2025-09-03,DCII,0,KK,0.18657163325385898,166677500,9,6,15,0.0
2025-09-03,DEFI,0,XL,0.7202614379084967,63805800,8,5,13,0.0
2025-09-03,DEPO,0,XL,0.7465671366694314,13771700,7,7,14,0.0
2025-09-03,DEWA,741532800,ZP,0.4136016762946626,5221716200,10,10,20,0.0
2025-09-03,DEWI,-3189100,XA,0.9018146430552216,2041121000,10,10,20,0.0
2025-09-03,DFAM,21787800,MG,0.2622492529229473,88170900,10,10,20,0.0
2025-09-03,DGIK,-9421700,MG,0.38843498972138013,190124400,10,10,20,0.0
2025-09-03,DGNS,21500,XC,0.4764912059774168,22702900,10,10,20,0.0
2025-09-03,DIGI,0,SQ,0.47191499937865045,7595000,10,4,14,0.0
2025-09-03,DILD,-28542900,XC,0.20920147244591653,98670000,10,10,20,0.0
2025-09-03,DIVA,15846200,CC,0.7351662322202537,148094900,10,10,20,0.0
2025-09-03,DKFT,1393213000,SQ,0.4250143467433921,9088780500,10,10,20,0.0
2025-09-03,DLTA,0,KK,0.35615535060647385,39698500,10,4,14,0.0
2025-09-03,DMAS,-147655300,CC,0.2245187267930991,374215600,10,10,20,0.0
2025-09-03,DMMX,-109800,NI,0.43449636568676697,88924200,10,10,20,0.0
2025-09-03,DMND,0,OD,0.41319175866676044,5876000,9,3,12,0.0
2025-09-03,DNAR,909100,XL,0.29434092293512015,55181800,10,10,20,0.0
2025-09-03,DNET,-40000,CC,0.43633014828250344,116672500,10,7,17,0.0
2025-09-03,DOID,-621749800,YP,0.24125358549289816,2185231600,10,10,20,0.0
2025-09-03,DOOH,2726700,AZ,0.3422188377964269,806139900,10,10,20,0.0
2025-09-03,DOSS,-32300,XL,0.7045005134158105,95160900,10,10,20,0.0
2025-09-03,DPNS,0,PD,0.4780518878851054,3302000,6,4,10,0.0
2025-09-03,DPUM,-1699400,BQ,0.29977572087110893,41034200,10,10,20,0.0
2025-09-03,DRMA,-8598000,BK,0.3363359084641224,139273000,10,10,20,0.0
2025-09-03,DSFI,1776100,RG,0.26707317475268255,24300000,10,10,20,0.0
2025-09-03,DSNG,947298000,BK,0.2791680615771037,7817291000,10,10,20,0.0
2025-09-03,DSSA,-2283877500,AK,0.3636512013991909,216772047500,10,10,20,0.0
2025-09-03,DUTI,-675000,XC,0.5006076015629382,26777000,10,5,15,0.0
2025-09-03,DVLA,-41984000,CC,0.5702378305054593,512860500,10,3,13,0.0
2025-09-03,DWGL,0,KK,0.5189947297356157,11915600,9,6,15,0.0
2025-09-03,DYAN,20700,XA,0.3513705862458596,40830000,10,10,20,0.0
2025-09-03,EAST,-6942300,KK,0.8137983427545123,622480700,10,7,17,0.0
2025-09-03,ECII,-570000,FS,0.5164709769941871,63456000,10,8,18,0.0
2025-09-03,EDGE,0,CC,0.3068442982865898,16422000,10,7,17,0.0
2025-09-03,EKAD,0,CC,0.5047121020572348,878300,8,6,14,0.0
2025-09-03,ELIT,-16501400,NI,0.32089686059075295,218143600,10,10,20,0.0
2025-09-03,ELPI,-13242800,CP,0.6350325289705593,321762600,10,10,20,0.0
2025-09-03,ELSA,-158412300,TP,0.20502786322920724,964858500,10,10,20,0.0
2025-09-03,ELTY,-218910600,EP,0.20363808254597435,321805800,10,6,16,0.0
2025-09-03,EMDE,-295700,XL,0.21648428607826042,16908700,10,5,15,0.0
2025-09-03,EMTK,928158000,AZ,0.6233119638002729,33073251000,10,10,20,0.0
2025-09-03,ENAK,-6095500,RG,0.34407438034513527,126490000,10,10,20,0.0
2025-09-03,ENRG,4526221000,BK,0.2666227841917966,10824712000,10,10,20,0.0
2025-09-03,ENZO,-18600,YB,0.35108947946092806,3902500,10,4,14,0.0
2025-09-03,EPAC,3188400,XL,0.3423560204128649,121855600,10,10,20,0.0
2025-09-03,EPMT,0,GR,0.5658462615187215,4851000,4,3,7,0.0
2025-09-03,ERAA,-1648912600,YP,0.20069349231998834,2796150000,10,10,20,0.0
2025-09-03,ERAL,-13707000,YP,0.26977799874152536,395468000,10,10,20,0.0
2025-09-03,ERTX,133400,YP,0.4663996474471171,29845100,7,10,17,0.0
2025-09-03,ESIP,-107800,DH,0.5510489063232848,15508500,10,3,13,0.0
2025-09-03,ESSA,1518182000,BB,0.4616351096014628,6181100000,10,10,20,0.0
2025-09-03,ESTA,11070700,XL,0.4083716432165476,190613100,10,10,20,0.0
2025-09-03,ESTI,-5400,KK,0.47961325960047824,38950400,10,7,17,0.0
2025-09-03,EURO,0,II,0.9501750007249187,176949000,8,5,13,0.0
2025-09-03,EXCL,-228569000,YP,0.25545427501647205,1063098000,10,10,20,0.0
2025-09-03,FAPA,0,SQ,0.7993313731018649,49612500,6,2,8,0.0
2025-09-03,FAST,-10053800,YP,0.2512484497922012,42463400,10,10,20,0.0
2025-09-03,FILM,1859351000,CC,0.3562688330442633,3092256000,10,10,20,0.0
2025-09-03,FIRE,-35009800,YP,0.401562136475358,419243600,10,10,20,0.0
2025-09-03,FITT,54428000,YP,0.22576604073765724,126693400,9,10,19,0.0
2025-09-03,FMII,0,NI,0.33005547150781644,523600,4,4,8,0.0
2025-09-03,FOLK,0,YP,0.501018237180947,7700500,9,6,15,0.0
2025-09-03,FOOD,0,LG,1.0,5900000,1,9,10,0.0
2025-09-03,FORU,1253000,CC,0.4186721704867523,84792000,7,10,17,0.0
2025-09-03,FPNI,-77300,XL,0.3886117717663144,36780200,10,8,18,0.0
2025-09-03,FUJI,-2422800,CC,0.5906590649698881,88289000,10,6,16,0.0
2025-09-03,FUTR,-415066400,YP,0.20855049899180683,1086716400,10,10,20,0.0
2025-09-03,FWCT,-9253400,XL,0.37285380670932616,163028500,10,8,18,0.0
2025-09-03,GDST,0,KK,0.30417281045617317,11840900,10,9,19,0.0
2025-09-03,GDYR,0,XC,0.7494736842105263,356000,2,3,5,0.0
2025-09-03,GEMA,-5300,XL,0.35211500347972174,99723300,10,10,20,0.0
2025-09-03,GEMS,-20652500,CC,0.2095363503159634,324620000,10,10,20,0.0
2025-09-03,GGRM,285127500,AK,0.8264816664671009,3779027500,10,10,20,0.0
2025-09-03,GGRP,-110600,NI,0.2187612168221004,20600000,10,10,20,0.0
2025-09-03,GHON,0,XL,0.5003709198813057,674500,3,3,6,0.0
2025-09-03,GIAA,-35956700,YP,0.3747731741701133,232161900,10,6,16,0.0
2025-09-03,GJTL,-71823500,AO,0.35116061577575164,821000000,10,10,20,0.0
2025-09-03,GLOB,0,YP,0.41061874056797915,598600,5,4,9,0.0
2025-09-03,GLVA,0,DR,0.4041272570937231,658000,6,2,8,0.0
2025-09-03,GMFI,373000,NI,0.5477878836801193,57342600,8,10,18,0.0
2025-09-03,GMTD,0,XC,1.0,1130000,1,3,4,0.0
2025-09-03,GOLD,0,YB,0.7581943310393094,3900000,7,4,11,0.0
2025-09-03,GOLF,-26837600,XL,0.431408500267181,165503400,10,10,20,0.0
2025-09-03,GOOD,-554800,YP,0.24316639945662905,12315600,10,8,18,0.0
2025-09-03,GOTO,-4268220400,AK,0.34379867744523607,9967674400,10,10,20,0.0
2025-09-03,GPRA,-165814400,BQ,0.7871874675770382,7894372100,10,10,20,0.0
2025-09-03,GPSO,1279200,KK,0.6777603119925011,702802200,10,10,20,0.0
2025-09-03,GRIA,29264700,MG,0.4423389261847342,463973900,7,10,17,0.0
2025-09-03,GRPH,-206565100,PD,0.2528053757681476,1270958600,10,10,20,0.0
2025-09-03,GRPM,-850000,XC,0.28292893752033843,27822100,10,10,20,0.0
2025-09-03,GSMF,-184904700,PD,0.27029839525277344,196628000,10,10,20,0.0
2025-09-03,GTBO,0,XL,0.4259623111869188,12986100,7,10,17,0.0
2025-09-03,GTRA,39300,CP,0.4719609270508798,29888200,10,10,20,0.0
2025-09-03,GTSI,-490268200,XL,0.29143161422558794,1208603100,10,10,20,0.0
2025-09-03,GULA,14781400,XL,0.6219737877830468,149023800,10,10,20,0.0
2025-09-03,GUNA,0,XC,0.5243327064568281,12713600,7,10,17,0.0
2025-09-03,GWSA,-76500,YP,0.6013455405223853,70273300,10,5,15,0.0
2025-09-03,GZCO,-1136123800,SQ,0.39062625414775204,5136293600,10,10,20,0.0
2025-09-03,HADE,177000,OD,0.4905433080351765,12216000,3,10,13,0.0
2025-09-03,HAIS,-1435600,PF,0.6112464717748886,132987000,10,7,17,0.0
2025-09-03,HAJJ,-36725800,AZ,0.184518937908185,57062500,10,10,20,0.0
2025-09-03,HALO,-662000,SQ,0.39152428266937733,29427200,10,8,18,0.0
2025-09-03,HATM,-18244800,AZ,0.7420550056940848,2186644800,10,10,20,0.0
2025-09-03,HDFA,25600,YP,0.9440252563929307,25147700,3,10,13,0.0
2025-09-03,HDIT,-16762800,XL,0.38334096099721204,208062600,10,10,20,0.0
2025-09-03,HEAL,62004500,YU,0.47490053332998255,3136945500,10,10,20,0.0
2025-09-03,HELI,-50400,ZR,0.7510358363015193,51660000,10,5,15,0.0
2025-09-03,HERO,0,CC,0.5156792892641949,2345000,7,5,12,0.0
2025-09-03,HEXA,-7727500,NI,0.29809215262778976,144917500,10,10,20,0.0
2025-09-03,HILL,-25004800,MG,0.461532088133268,655080000,10,7,17,0.0
2025-09-03,HMSP,272850500,DX,0.37608590987827634,1891928000,10,10,20,0.0
2025-09-03,HOKI,88522600,ZP,0.4013134112183349,469704400,10,10,20,0.0
2025-09-03,HOMI,0,YU,0.7355324547761316,19769200,4,10,14,0.0
2025-09-03,HOPE,44059600,OD,0.3631741601036786,269582000,8,10,18,0.0
2025-09-03,HRME,199200,HD,0.9379657767837905,100990400,4,10,14,0.0
2025-09-03,HRTA,7370647500,KZ,0.4577427571712708,22906986500,10,10,20,0.0
2025-09-03,HRUM,7342129000,MG,0.25112226734956095,15996084500,10,10,20,0.0
2025-09-03,HUMI,-1549634100,CC,0.18256677173089902,2043990100,10,10,20,0.0
2025-09-03,HYGN,0,AO,0.40656814885777093,101091300,9,10,19,0.0
2025-09-03,IATA,1150000,KK,0.31646247718132925,242561400,9,10,19,0.0
2025-09-03,IBFN,0,DR,0.358904299905064,1550000,8,2,10,0.0
2025-09-03,IBOS,-59383200,GR,0.3566060236123961,152598600,10,10,20,0.0
2025-09-03,IBST,0,AG,0.9615384615384616,66250000,4,3,7,0.0
2025-09-03,ICBP,672672500,AK,0.2842255288224524,3702790000,10,10,20,0.0
2025-09-03,ICON,0,YP,0.4645754542973424,30980400,6,7,13,0.0
2025-09-03,IDEA,-13292600,CC,0.48736548160391224,429094700,10,9,19,0.0
2025-09-03,IDPR,-60200,MU,0.4576977481378154,46723800,10,6,16,0.0
2025-09-03,IFII,0,SQ,0.7845467384407556,76661200,7,10,17,0.0
2025-09-03,IFSH,0,ZP,0.8340307045088262,55114000,6,8,14,0.0
2025-09-03,IGAR,0,CC,0.8678597082981979,13894000,3,1,4,0.0
2025-09-03,IKAI,70000,AO,0.4314249967643125,40000000,9,10,19,0.0
2025-09-03,IKAN,32533500,XL,0.4974612354857691,612498400,10,10,20,0.0
2025-09-03,IKBI,-2917500,XL,0.33785127059676534,43335000,10,6,16,0.0
2025-09-03,IKPM,178800,CC,0.383697926180719,44530600,10,10,20,0.0
2025-09-03,IMAS,12071000,YP,0.8634229948918428,538017000,10,10,20,0.0
2025-09-03,IMJS,26079200,NI,0.34182017981556073,443567400,10,10,20,0.0
2025-09-03,IMPC,1168704000,TP,0.3446290372995598,21116160000,10,10,20,0.0
2025-09-03,INAI,-400,KK,0.2685218705239797,1706000,10,3,13,0.0
2025-09-03,INCF,0,YU,0.533585740737953,21266700,5,10,15,0.0
2025-09-03,INCI,0,XL,0.7522616562282533,8107500,5,3,8,0.0
2025-09-03,INCO,10820823000,BB,0.33674796672074897,14718403000,10,10,20,0.0
2025-09-03,INDF,2222710000,YU,0.37112982379918746,14914790000,10,10,20,0.0
2025-09-03,INDO,-14811400,AG,0.20594510097960042,99100000,10,10,20,0.0
2025-09-03,INDR,-259000,YP,0.6218930033262718,129753000,10,5,15,0.0
2025-09-03,INDS,0,XL,0.5477229705417624,7002200,9,6,15,0.0
2025-09-03,INDX,-7852600,CP,0.194670146593097,48825200,10,9,19,0.0
2025-09-03,INDY,10631938000,ZP,0.1960251990743689,11028969500,10,10,20,0.0
2025-09-03,INET,-359104200,GR,0.18361881805251834,803080000,10,10,20,0.0
2025-09-03,INKP,718057500,DR,0.2814396993380017,3100627500,10,10,20,0.0
2025-09-03,INOV,-232500,SQ,0.2867513898977344,14488200,10,9,19,0.0
2025-09-03,INPC,-376410700,XL,0.3126924518582629,530481400,10,10,20,0.0
2025-09-03,INPP,0,IF,0.8204219479653102,29515500,4,6,10,0.0
2025-09-03,INPS,0,DR,0.6119530214055693,1292200,4,3,7,0.0
2025-09-03,INRU,2457000,XL,0.4862290383058318,56149000,10,10,20,0.0
2025-09-03,INTA,-105000,NI,0.6069333550594753,62575800,10,7,17,0.0
2025-09-03,INTD,1922300,MG,0.2711013854933788,28853700,10,10,20,0.0
2025-09-03,INTP,1183570000,KZ,0.39487947469171275,3530030000,10,10,20,0.0
2025-09-03,IOTF,-23398200,CC,0.3788351206491041,510291400,10,10,20,0.0
2025-09-03,IPAC,0,XL,0.9211593931008606,3928100,3,7,10,0.0
2025-09-03,IPCC,-64500,BB,0.30822719252032427,328218500,10,10,20,0.0
2025-09-03,IPCM,-175000,XL,0.5407730413922677,66545800,10,9,19,0.0
2025-09-03,IPOL,0,XL,0.5046268695404236,5840400,8,5,13,0.0
2025-09-03,IPTV,467900,EP,0.417089431978963,142560000,10,10,20,0.0
2025-09-03,IRRA,-26583600,CC,0.21628564950758972,86429000,10,10,20,0.0
2025-09-03,ISAP,5916900,MG,0.6741516629831276,660326700,6,10,16,0.0
2025-09-03,ISAT,-978792500,CC,0.7455385176756338,27427621000,10,10,20,0.0
2025-09-03,ISEA,3632200,CP,0.41042738142026536,72891000,10,10,20,0.0
2025-09-03,ISSP,-46159400,KK,0.41012255955584864,473777600,10,10,20,0.0
2025-09-03,ITIC,0,CC,0.42913075481449386,16440600,8,7,15,0.0
2025-09-03,ITMA,119172000,KI,0.5318943707246415,9945007500,10,10,20,0.0
2025-09-03,ITMG,-3677635000,YP,0.25579291409857763,3838192500,10,10,20,0.0
2025-09-03,JAST,1558400,DR,0.3690113576944833,113903400,10,10,20,0.0
2025-09-03,JATI,-541000,XL,0.45286935277818635,60653200,10,10,20,0.0
2025-09-03,JAWA,1400600,DR,0.343464707941723,30609300,9,10,19,0.0
2025-09-03,JAYA,-211600,EP,0.40630956632488413,18886000,10,6,16,0.0
2025-09-03,JECC,-4190000,XC,0.4200552434433223,82956500,10,5,15,0.0
2025-09-03,JGLE,-178520500,XL,0.37020776521299237,675977500,10,8,18,0.0
2025-09-03,JIHD,-9315500,XL,0.44903092303615105,229583000,10,10,20,0.0
2025-09-03,JKON,-150366200,DX,0.2720040809486519,774231600,10,10,20,0.0
2025-09-03,JMAS,59700,MU,0.3118803966236794,32186400,7,10,17,0.0
2025-09-03,JPFA,-4006725500,YJ,0.2764139134605676,6011745000,10,10,20,0.0
2025-09-03,JRPT,0,CP,0.4567298028190154,85205000,5,10,15,0.0
2025-09-03,JSMR,1074458000,RX,0.39052426916483557,3056034000,10,10,20,0.0
2025-09-03,JSPT,0,XL,0.525183965592554,15630000,7,4,11,0.0
2025-09-03,JTPE,-11181600,EP,0.3451799156339713,55742000,10,10,20,0.0
2025-09-03,KAEF,-7175000,XL,0.24664976195104402,85014500,10,8,18,0.0
2025-09-03,KARW,-19774000,XL,0.4844665471665109,128785500,10,5,15,0.0
2025-09-03,KBAG,791300,MG,0.5237685948144679,91590000,10,10,20,0.0
2025-09-03,KBLI,0,XC,0.6561482594540445,1572000,7,3,10,0.0
2025-09-03,KBLM,58800,XL,0.5802881017710152,44666400,8,10,18,0.0
2025-09-03,KBLV,-1014762000,KK,0.29331923999109116,4226458400,10,10,20,0.0
2025-09-03,KDSI,0,YP,0.4748035469684954,1317200,4,3,7,0.0
2025-09-03,KDTN,0,XL,0.5182894457421958,1952500,6,3,9,0.0
2025-09-03,KEEN,-22160500,CC,0.31016417592353973,695648000,10,10,20,0.0
2025-09-03,KEJU,-670500,KK,0.3644426751323751,108025000,10,10,20,0.0
2025-09-03,KETR,-252057000,PD,0.2383343542827696,569797500,10,10,20,0.0
2025-09-03,KICI,18317900,DH,0.7499956844550234,195513000,10,10,20,0.0
2025-09-03,KIJA,-600165200,KI,0.322603237546567,6565710000,10,10,20,0.0
2025-09-03,KING,4612200,IU,0.28033234212409636,58600000,10,10,20,0.0
2025-09-03,KINO,4013500,LG,0.26833257961874263,65862500,8,10,18,0.0
2025-09-03,KIOS,-2488200,GR,0.6881207088240285,390048700,10,10,20,0.0
2025-09-03,KJEN,-5906800,MG,0.23565980798318187,19101500,10,6,16,0.0
2025-09-03,KKES,10000,XL,0.4352990450661752,10393200,5,10,15,0.0
2025-09-03,KKGI,-6377000,YP,0.18011438898767518,63065000,10,10,20,0.0
2025-09-03,KLAS,-1088700,AZ,0.21767276412666553,54768100,10,10,20,0.0
2025-09-03,KLBF,-28356031000,CC,0.27367103632314993,21844058000,10,10,20,0.0
2025-09-03,KLIN,-4270500,YP,0.4526677606681316,104960300,10,8,18,0.0
2025-09-03,KMDS,0,CC,0.5738791022546351,11174000,7,5,12,0.0
2025-09-03,KMTR,3996400,XL,0.73958865869524,226259400,9,10,19,0.0
2025-09-03,KOBX,0,PD,0.38381008552049545,5986900,7,4,11,0.0
2025-09-03,KOCI,-24387100,YU,0.1761549077526512,58204400,10,10,20,0.0
2025-09-03,KOIN,0,KK,0.8987222894990485,109095000,9,5,14,0.0
2025-09-03,KOKA,-933000,XL,0.43769316423038396,172365100,10,10,20,0.0
2025-09-03,KONI,0,CP,0.4479279399277401,26903000,10,5,15,0.0
2025-09-03,KOPI,-67800,AZ,0.301278374170286,10294200,10,6,16,0.0
2025-09-03,KOTA,5614000,GR,0.3262156580511922,72976400,9,10,19,0.0
2025-09-03,KPIG,-249080100,EP,0.3829376169836415,1458967200,10,10,20,0.0
2025-09-03,KRAS,188387800,ZP,0.2752341679426578,1524979000,10,10,20,0.0
2025-09-03,KREN,-2350400,PD,0.34077897930224593,133718400,10,8,18,0.0
2025-09-03,KRYA,-26782400,XC,0.27872647028903946,102474400,10,10,20,0.0
2025-09-03,KUAS,24339500,SS,0.3847196481194227,184352000,10,10,20,0.0
2025-09-03,LABS,0,YP,0.5066549308339181,34076800,5,8,13,0.0
2025-09-03,LAJU,-83407300,GR,0.3587375702618647,365754800,10,10,20,0.0
2025-09-03,LAND,-1320700,YP,0.6465045491164525,402530800,10,10,20,0.0
2025-09-03,LCKM,0,XL,0.23076629958465114,6056000,10,4,14,0.0
2025-09-03,LEAD,-19437400,XC,0.2589768997763404,82744000,10,10,20,0.0
2025-09-03,LFLO,0,PC,0.38314393939393937,404600,6,1,7,0.0
2025-09-03,LINK,0,XL,0.5822770380544334,209427000,8,5,13,0.0
2025-09-03,LION,0,PD,1.0,10059200,1,8,9,0.0
2025-09-03,LIVE,1172700,AZ,0.871565936678254,2726838800,10,10,20,0.0
2025-09-03,LMAX,-206300,PD,0.33293350191090604,9242800,10,10,20,0.0
2025-09-03,LMPI,293100,YP,0.7578268994120596,41568700,7,10,17,0.0
2025-09-03,LOPI,1178500,YU,0.393576568032424,48097300,9,10,19,0.0
2025-09-03,LPCK,-2412500,PD,0.3226351586103769,174117000,10,10,20,0.0
2025-09-03,LPGI,0,AG,0.3886281948881789,1557000,7,2,9,0.0
2025-09-03,LPIN,0,NI,0.4545104388358642,13924200,7,6,13,0.0
2025-09-03,LPKR,-95615200,YP,0.18032258532385045,831745300,10,10,20,0.0
2025-09-03,LPLI,-64000,LG,0.7002614322415506,74303200,10,10,20,0.0
2025-09-03,LPPF,-45152500,LG,0.2797654697355695,429984000,10,7,17,0.0
2025-09-03,LPPS,8722900,XL,0.5756209407216065,86261000,10,10,20,0.0
2025-09-03,LRNA,0,PD,0.46981842472824437,3094600,6,8,14,0.0
2025-09-03,LSIP,207479500,KZ,0.4242026296998117,2576446000,10,10,20,0.0
2025-09-03,LTLS,0,CC,0.6928573839092873,41061500,8,4,12,0.0
2025-09-03,LUCK,10000,YP,0.38995288496245933,36839200,8,10,18,0.0
2025-09-03,LUCY,-3065200,CC,0.20572391436367213,12025900,10,10,20,0.0
2025-09-03,MAHA,1565000,PD,0.3711096257025571,87276300,10,10,20,0.0
2025-09-03,MAIN,50695000,AZ,0.42776743413731094,908100000,10,10,20,0.0
2025-09-03,MANG,3373400,MG,0.2476252245470457,78421200,10,10,20,0.0
2025-09-03,MAPA,-237646000,YP,0.7428373063812946,15561269000,10,10,20,0.0
2025-09-03,MAPB,0,OD,0.504424778761062,1026000,4,2,6,0.0
2025-09-03,MAPI,-595714500,KZ,0.45079879323508254,4745180000,10,10,20,0.0
2025-09-03,MARI,422700,LG,0.6949387496143333,63968000,9,10,19,0.0
2025-09-03,MARK,-22418000,DR,0.22902334640918492,236102000,10,10,20,0.0
2025-09-03,MAXI,118023200,XL,0.3451392881012926,1304570700,10,10,20,0.0
2025-09-03,MAYA,15724200,NI,0.2278173734326018,259979400,10,10,20,0.0
2025-09-03,MBAP,0,AZ,0.8802495195488484,209550000,10,6,16,0.0
2025-09-03,MBMA,1521937600,XL,0.2840393703492947,8134203600,10,10,20,0.0
2025-09-03,MBSS,151571000,KK,0.3113483806500911,529697000,10,10,20,0.0
2025-09-03,MBTO,2048700,BQ,0.2709458100755653,28430100,10,10,20,0.0
2025-09-03,MCAS,-3762500,NI,0.2702134295395924,32056500,10,7,17,0.0
2025-09-03,MCOL,-760000,XL,0.3344139362147431,37549000,10,5,15,0.0
2025-09-03,MCOR,-659100,SQ,0.6240138741984715,195810000,10,10,20,0.0
2025-09-03,MDIA,0,XL,0.7202939613954312,55318000,8,4,12,0.0
2025-09-03,MDIY,-2515000,YU,0.8708794205554464,2554784000,10,7,17,0.0
2025-09-03,MDKA,-11371314000,CP,0.20307448167800712,7202070000,10,10,20,0.0
2025-09-03,MDKI,-16391900,XA,0.3743134424818237,119658500,10,4,14,0.0
2025-09-03,MDLN,5175700,DR,0.3005296658109548,135471200,10,10,20,0.0
2025-09-03,MDRN,1260000,OD,0.49063216422040107,55857000,6,10,16,0.0
2025-09-03,MEDC,3201028500,ZP,0.4720264775014451,7691620000,10,10,20,0.0
2025-09-03,MEDS,222016900,MG,0.3673484563033219,1373378600,10,10,20,0.0
2025-09-03,MEGA,0,CC,0.29659351457582706,3622000,7,4,11,0.0
2025-09-03,MEJA,762300,HP,0.30877105891843254,197049600,10,10,20,0.0
2025-09-03,MENN,-124883700,YP,0.27985350279748494,638009400,10,10,20,0.0
2025-09-03,MERK,0,CC,0.6134800550206327,16056000,7,3,10,0.0
2025-09-03,MFIN,-1883000,XL,0.3980633256584856,60942500,10,10,20,0.0
2025-09-03,MGNA,0,XC,0.6413274336283186,3623500,6,2,8,0.0
2025-09-03,MGRO,-12326500,ZP,0.31352626732825206,245165000,10,10,20,0.0
2025-09-03,MHKI,-129447700,PD,0.27894620346044,297670300,10,10,20,0.0
2025-09-03,MICE,0,YP,0.34106614790050954,6539500,7,6,13,0.0
2025-09-03,MIDI,23487600,CC,0.40310499786369114,469466400,10,10,20,0.0
2025-09-03,MIKA,1323829000,AK,0.30786214204042545,4374512000,10,10,20,0.0
2025-09-03,MINA,788517300,XL,0.6711215351847611,5359348600,10,10,20,0.0
2025-09-03,MIRA,-29770400,XL,0.3956425116508249,505537600,10,10,20,0.0
2025-09-03,MITI,-5378200,CC,0.32855176269914854,222819600,10,10,20,0.0
2025-09-03,MKAP,-28518200,OD,0.2058389187383517,24894200,10,10,20,0.0
2025-09-03,MKPI,0,XC,1.0,10040000,1,3,4,0.0
2025-09-03,MKTR,-403784000,XL,0.29335431618339447,1383769500,10,10,20,0.0
2025-09-03,MLBI,-4700000,CC,0.7704143945779506,223932500,10,7,17,0.0
2025-09-03,MLIA,33852200,IF,0.31103020817545557,218759800,10,10,20,0.0
2025-09-03,MLPL,-244033600,LG,0.2550702708794398,706162300,10,10,20,0.0
2025-09-03,MLPT,0,YU,0.9091328514087431,936000000,8,9,17,0.0
2025-09-03,MMIX,-31249000,YP,0.26973199210482507,77129000,10,10,20,0.0
2025-09-03,MMLP,-1896000,ZP,0.30025516420025194,406025000,10,10,20,0.0
2025-09-03,MNCN,27832600,ZP,0.3699111997630803,745694000,10,10,20,0.0
2025-09-03,MOLI,-2087400,YP,0.27301817687216057,61020600,10,9,19,0.0
2025-09-03,MORA,0,CP,0.3608004776229075,25140000,10,8,18,0.0
2025-09-03,MPIX,-1543200,KK,0.24976966966141897,68181500,10,10,20,0.0
2025-09-03,MPMX,-5975500,YP,0.470057612246338,226493500,10,10,20,0.0
2025-09-03,MPOW,118000,GR,0.9301699119790818,77693000,8,10,18,0.0
2025-09-03,MPPA,-41920200,ZP,0.32318485902225286,375245900,10,10,20,0.0
2025-09-03,MPRO,2727000,FZ,0.5514742810258524,1199097000,10,10,20,0.0
2025-09-03,MPXL,-4595800,CP,0.3455710318159228,70438400,10,10,20,0.0
2025-09-03,MRAT,238000,AI,0.7859200097371628,118810200,6,10,16,0.0
2025-09-03,MREI,0,ZP,0.8530911794559056,102118000,6,7,13,0.0
2025-09-03,MSIE,1261100,AZ,0.3847966007844955,125853000,9,10,19,0.0
2025-09-03,MSIN,131398000,BK,0.6443808677095588,2683200000,10,10,20,0.0
2025-09-03,MSJA,0,DR,0.6369459148418283,207878000,10,7,17,0.0
2025-09-03,MSKY,13212100,XL,0.33888264109469246,217624400,10,10,20,0.0
2025-09-03,MSTI,-111494000,DX,0.5663186519722163,886951000,10,10,20,0.0
2025-09-03,MTDL,-14129000,KZ,0.32912517306454725,265175000,10,10,20,0.0
2025-09-03,MTEL,16995500,RG,0.4460240406117353,355530000,10,10,20,0.0
2025-09-03,MTFN,-44046000,CC,0.2816879038484824,268693500,10,8,18,0.0
2025-09-03,MTLA,0,LG,0.45041133455210236,394200,4,4,8,0.0
2025-09-03,MTMH,29634500,SQ,0.6452659776528995,788164000,7,10,17,0.0
2025-09-03,MTPS,0,XL,1.0,25424200,1,9,10,0.0
2025-09-03,MTWI,0,MG,0.3945685563860686,37711600,10,4,14,0.0
2025-09-03,MUTU,-128038100,XL,0.26849569798845907,212858100,10,10,20,0.0
2025-09-03,MYOH,0,TP,0.7392039482703469,16176000,5,4,9,0.0
2025-09-03,MYOR,-27238000,BK,0.2742137731895171,419651000,10,10,20,0.0
2025-09-03,NAIK,-34249100,nan,0.577914330881228,682233300,10,10,20,0.0
2025-09-03,NANO,13422900,AG,0.30715734226146196,259080000,10,10,20,0.0
2025-09-03,NASA,-6600,XC,0.5462812160694897,39847500,10,7,17,0.0
2025-09-03,NASI,1114500,GR,0.419031823520362,55836200,10,10,20,0.0
2025-09-03,NATO,0,YP,0.6098746949889784,10347500,9,5,14,0.0
2025-09-03,NAYZ,-64390600,XA,0.3470404011196855,385025500,10,10,20,0.0
2025-09-03,NCKL,440749500,RX,0.16324331444589057,3166346500,10,10,20,0.0
2025-09-03,NELY,-466400,CC,0.27557078226969506,100431000,10,10,20,0.0
2025-09-03,NEST,-73688800,RG,0.25291213096949966,255415000,10,10,20,0.0
2025-09-03,NETV,-36800,PD,0.34251988459962573,16217700,10,7,17,0.0
2025-09-03,NFCX,0,PG,0.491363135783334,24093500,8,4,12,0.0
2025-09-03,NICE,44750400,CC,0.2131655930675545,161985600,10,10,20,0.0
2025-09-03,NICK,0,LG,0.8702044245309437,31075000,7,2,9,0.0
2025-09-03,NICL,408098500,nan,0.31164943247945365,1878725000,10,10,20,0.0
2025-09-03,NIKL,-14427600,EP,0.2816230556517525,108320000,10,4,14,0.0
2025-09-03,NIRO,0,CC,0.6623235613463626,61000,4,1,5,0.0
2025-09-03,NISP,120756000,ZP,0.6301600519020214,2997939500,10,10,20,0.0
2025-09-03,NOBU,82533500,PD,0.341336865094961,475507000,10,10,20,0.0
2025-09-03,NPGF,-32649600,XL,0.6469810605891488,623112700,10,10,20,0.0
2025-09-03,NRCA,-348902500,XL,0.27693378450349104,506722500,10,10,20,0.0
2025-09-03,NSSS,45122400,IF,0.5726504836799241,1358150800,9,10,19,0.0
2025-09-03,NTBK,132859000,CP,0.36680831524638985,603929900,10,10,20,0.0
2025-09-03,NZIA,-2550800,YP,0.2906814420156505,18844500,10,5,15,0.0
2025-09-03,OASA,324425800,KI,0.5590048884627628,7648608200,10,10,20,0.0
2025-09-03,OBMD,-15295200,AZ,0.3732260852681619,238358600,10,8,18,0.0
2025-09-03,OILS,1033700,GR,0.3064868007809781,43592200,10,10,20,0.0
2025-09-03,OKAS,14225200,XL,0.7706974119169123,1128505400,10,10,20,0.0
2025-09-03,OLIV,1419000,MG,0.9928537846732487,69689400,2,10,12,0.0
2025-09-03,OMED,0,DR,0.539367210076686,19616300,10,7,17,0.0
2025-09-03,OPMS,-4826300,CC,0.24581794349037156,30155200,10,5,15,0.0
2025-09-03,PACK,-1108058000,XL,0.5652422034427269,11685598000,10,10,20,0.0
2025-09-03,PADA,2195200,MG,0.4910375506999869,220676400,5,10,15,0.0
2025-09-03,PADI,-432000,DH,0.5179728761372099,198707500,10,8,18,0.0
2025-09-03,PALM,-6248600,CC,0.25745034685926066,32509800,10,7,17,0.0
2025-09-03,PAMG,-4313400,CC,0.21511449241825195,52150400,10,10,20,0.0
2025-09-03,PANI,-26208117500,XL,0.16342378655864065,26610282500,10,10,20,0.0
2025-09-03,PANR,2273000,BR,0.22568692535509915,215161000,10,10,20,0.0
2025-09-03,PANS,-1250000,DH,0.30780124409482484,28798500,10,3,13,0.0
2025-09-03,PART,491400,TP,0.4978292972722983,635524500,10,10,20,0.0
2025-09-03,PBID,1075800,XL,0.8393416697531408,114215600,5,10,15,0.0
2025-09-03,PBRX,-149220000,GR,0.2989643254878375,374007600,10,10,20,0.0
2025-09-03,PBSA,-576681500,XL,0.2815504902298589,1587272000,10,10,20,0.0
2025-09-03,PCAR,-333800,CP,0.7855974852457367,846416400,10,10,20,0.0
2025-09-03,PDES,0,PC,1.0,239000,1,1,2,0.0
2025-09-03,PDPP,50000,KK,0.5858110524745854,165754300,7,10,17,0.0
2025-09-03,PEGE,-89600,LS,0.5444173741848161,22122400,10,9,19,0.0
2025-09-03,PEHA,0,NI,0.6128737297931439,7104800,8,6,14,0.0
2025-09-03,PEVE,-89200,SH,0.330092324349014,15610000,10,10,20,0.0
2025-09-03,PGAS,15675537500,AK,0.33691177384878473,39377530000,10,10,20,0.0
2025-09-03,PGEO,-3582276000,YP,0.26063685827678,4557515000,10,10,20,0.0
2025-09-03,PGLI,0,AI,0.46055355375975526,27276100,7,9,16,0.0
2025-09-03,PICO,0,KK,0.5699593743002463,14254000,6,10,16,0.0
2025-09-03,PIPA,-201012300,CP,0.22517399353776488,1162109200,10,10,20,0.0
2025-09-03,PJAA,0,GR,0.41184492177492005,9966400,7,9,16,0.0
2025-09-03,PKPK,0,SQ,0.6282526401946185,55265500,7,4,11,0.0
2025-09-03,PLAN,-3207300,XL,0.6405614153949168,161863400,10,10,20,0.0
2025-09-03,PMJS,0,OD,0.46114212108200947,8914200,7,7,14,0.0
2025-09-03,PNBN,-6966000,KK,0.2633678989105734,639100000,10,10,20,0.0
2025-09-03,PNBS,177777400,XL,0.24861495037385303,428567200,10,10,20,0.0
2025-09-03,PNGO,0,XL,0.713955362461021,20377000,4,5,9,0.0
2025-09-03,PNIN,-592000,XL,0.35836167746593955,94297500,10,9,19,0.0
2025-09-03,PNLF,-200398200,MG,0.23894234594051575,1466879200,10,10,20,0.0
2025-09-03,PNSE,-1040000,CC,0.41616648617339996,102028000,10,9,19,0.0
2025-09-03,POLA,-12000,CC,0.6398371631674658,74311200,10,5,15,0.0
2025-09-03,POLI,0,XL,1.0,157000,1,1,2,0.0
2025-09-03,POLU,810000,CC,0.46053864617335477,330497500,10,10,20,0.0
2025-09-03,POLY,0,XL,0.4351229105211406,1106300,9,2,11,0.0
2025-09-03,PORT,0,AI,0.9994889065085684,180892000,2,8,10,0.0
2025-09-03,POWR,63318500,CD,0.30703265165527455,376150000,10,10,20,0.0
2025-09-03,PPGL,0,NI,0.7884662376802151,968000,5,6,11,0.0
2025-09-03,PPRE,90297300,AZ,0.3389181753106419,2143079400,10,10,20,0.0
2025-09-03,PPRI,-33442200,OD,0.27781048781599965,138909800,10,10,20,0.0
2025-09-03,PRAY,0,XL,1.0,6684000,1,7,8,0.0
2025-09-03,PRDA,-1614000,CC,0.23188940545593192,37708000,10,6,16,0.0
2025-09-03,PRIM,-20340200,BQ,0.31845768068702146,237996800,10,10,20,0.0
2025-09-03,PSAB,-1045006500,YP,0.21077159748128552,4735693500,10,10,20,0.0
2025-09-03,PSDN,1076500,XA,0.3317294216263758,199296800,10,10,20,0.0
2025-09-03,PSGO,-593400,OD,0.48278629029953535,84473600,10,9,19,0.0
2025-09-03,PSKT,110694800,MG,0.7320297190777201,1422122700,8,10,18,0.0
2025-09-03,PSSI,-481600,II,0.8977281532122715,1052025000,10,7,17,0.0
2025-09-03,PTBA,-938907000,YP,0.3531463707005167,2884454000,10,10,20,0.0
2025-09-03,PTIS,0,YP,0.44621594804257625,15829600,8,5,13,0.0
2025-09-03,PTMP,-758100,EP,0.27653583461128345,82859400,10,10,20,0.0
2025-09-03,PTPP,1721545800,ZP,0.20666854689605466,1945525000,10,10,20,0.0
2025-09-03,PTPS,52022700,AK,0.4922734620922908,487126300,10,10,20,0.0
2025-09-03,PTPW,0,IH,0.33779427566669923,8645000,8,3,11,0.0
2025-09-03,PTRO,642186000,AZ,0.26087391741998595,4993318000,10,10,20,0.0
2025-09-03,PTSN,-229480700,XL,0.4895612158428092,1324708100,10,10,20,0.0
2025-09-03,PTSP,0,PD,0.5542404428960054,5806500,5,6,11,0.0
2025-09-03,PUDP,0,XL,0.3787710624558571,1501600,6,3,9,0.0
2025-09-03,PURA,-3892000,GR,0.4921424577235302,142928800,10,10,20,0.0
2025-09-03,PURI,0,CP,0.5086032208265124,18548200,9,4,13,0.0
2025-09-03,PWON,370877600,DX,0.19471929375054306,1399260400,10,10,20,0.0
2025-09-03,PYFA,12169000,PD,0.25024061793172925,985652000,10,10,20,0.0
2025-09-03,PZZA,-5125600,NI,0.24806252874060203,110154200,10,7,17,0.0
2025-09-03,RAAM,94216000,CC,0.28451644096606343,207724600,10,10,20,0.0
2025-09-03,RAJA,-2189552000,PG,0.5283928970923244,10311971000,10,10,20,0.0
2025-09-03,RALS,-15526600,TP,0.3157496514474111,276930000,10,10,20,0.0
2025-09-03,RANC,0,YP,0.3474954434039344,1105800,6,5,11,0.0
2025-09-03,RBMS,0,YP,0.38531736451009513,15799900,9,7,16,0.0
2025-09-03,RCCC,197400,YU,0.25806256335750666,25151500,9,10,19,0.0
2025-09-03,RDTX,0,XC,1.0,3690000,1,3,4,0.0
2025-09-03,REAL,23330900,BQ,0.4214289549532628,203283800,10,10,20,0.0
2025-09-03,RELF,-59864700,PD,0.19564846577368425,204280300,10,10,20,0.0
2025-09-03,RELI,0,XL,0.431164457626595,13955500,8,4,12,0.0
2025-09-03,RGAS,61292100,AT,0.7324855812317321,1096929900,10,10,20,0.0
2025-09-03,RICY,11600,XL,0.2990641247833622,25021200,9,10,19,0.0
2025-09-03,RIGS,-3197000,RF,0.42009873807189924,458356500,10,10,20,0.0
2025-09-03,RISE,1093500,IH,0.41199282987703467,162381000,9,10,19,0.0
2025-09-03,RMKE,-1420755000,MG,0.18030214156187854,678704500,10,10,20,0.0
2025-09-03,RMKO,48072500,XL,0.29241605092772915,645578700,10,10,20,0.0
2025-09-03,ROCK,0,XC,0.6,750000,2,1,3,0.0
2025-09-03,RODA,0,PD,0.7102034511673065,6437000,6,5,11,0.0
2025-09-03,ROTI,0,CD,0.4143989693786542,41817000,10,9,19,0.0
2025-09-03,RSCH,-6200,PS,0.47155831956065425,490240800,10,9,19,0.0
2025-09-03,RUIS,-129200,YP,0.348293401649691,16831000,10,6,16,0.0
2025-09-03,RUNS,0,XL,0.7663451374048641,127736400,10,7,17,0.0
2025-09-03,SAFE,0,SF,0.4458523171487882,14884200,6,10,16,0.0
2025-09-03,SAGE,-1336600,CC,0.1913569162626444,13107700,10,6,16,0.0
2025-09-03,SAME,2899200,XL,0.743171531137818,215219800,10,10,20,0.0
2025-09-03,SAMF,-401600,EP,0.2729602409708885,9352000,10,6,16,0.0
2025-09-03,SAPX,-31200,YP,0.5160388838918524,21457000,10,5,15,0.0
2025-09-03,SATU,2327600,AK,0.5915743405800852,178319200,10,10,20,0.0
2025-09-03,SBMA,0,YP,0.5936282486863286,128369200,10,10,20,0.0
2025-09-03,SCCO,0,NI,0.62087639520463,30038000,7,9,16,0.0
2025-09-03,SCMA,2662787000,AK,0.3425995498547223,5359145800,10,10,20,0.0
2025-09-03,SCNP,0,XL,0.9125159017516391,2797500,3,2,5,0.0
2025-09-03,SDMU,0,XL,0.6162109375,20949200,6,9,15,0.0
2025-09-03,SDPC,0,XL,0.6850529202115102,24084200,8,5,13,0.0
2025-09-03,SDRA,0,DP,0.7518881496133789,46830000,9,7,16,0.0
2025-09-03,SEMA,-7373100,XL,0.6468762668290877,355364000,10,10,20,0.0
2025-09-03,SFAN,0,FZ,0.40154224517191034,20490500,8,6,14,0.0
2025-09-03,SGER,481893200,CP,0.42312232926127696,4290572800,10,10,20,0.0
2025-09-03,SGRO,116276000,AK,0.3580176472172926,1701065000,10,10,20,0.0
2025-09-03,SHID,0,XC,0.3994182143656299,892500,4,3,7,0.0
2025-09-03,SHIP,0,FZ,0.589153813266682,89572000,8,8,16,0.0
2025-09-03,SICO,-448100,XL,0.3160863031795681,109654100,10,10,20,0.0
2025-09-03,SIDO,408822000,ZP,0.25436015544395296,1244016000,10,10,20,0.0
2025-09-03,SILO,8064000,DP,0.9202883711322583,1033609000,8,10,18,0.0
2025-09-03,SIMP,582204500,AK,0.22970259576028126,1544782000,10,10,20,0.0
2025-09-03,SINI,0,NI,0.9324187965411095,1825000000,5,7,12,0.0
2025-09-03,SKBM,0,OD,0.6025539965316097,4586400,10,4,14,0.0
2025-09-03,SKLT,0,KK,0.5554849301466648,29538300,7,9,16,0.0
2025-09-03,SKRN,-242000,XC,0.4931979708950537,133334000,10,2,12,0.0
2025-09-03,SMAR,2255000,BB,0.32113292387736997,186400000,10,10,20,0.0
2025-09-03,SMBR,1613252600,AK,0.22043211495660683,1664478800,10,10,20,0.0
2025-09-03,SMDM,0,NI,0.27615030674846625,12603500,10,5,15,0.0
2025-09-03,SMDR,-56982800,ZP,0.4298846130493874,1546329000,10,10,20,0.0
2025-09-03,SMGA,-83220600,AI,0.27424483698571495,500850000,10,10,20,0.0
2025-09-03,SMGR,2107019000,ZP,0.23354854851650855,3903668000,10,10,20,0.0
2025-09-03,SMIL,-2048148400,YP,0.4573526775255946,9555593800,10,10,20,0.0
2025-09-03,SMKL,101500,NI,0.6862852742629358,28252100,3,10,13,0.0
2025-09-03,SMLE,0,XL,0.39258840982598703,23499400,9,10,19,0.0
2025-09-03,SMMA,-14412500,AZ,0.3684463352852088,414182500,10,8,18,0.0
2025-09-03,SMMT,0,PD,0.4186999528968441,53334000,6,10,16,0.0
2025-09-03,SMRA,-1382151400,KK,0.3440506346928833,2493514200,10,10,20,0.0
2025-09-03,SMSM,1725500,BB,0.3839437981255909,315752500,10,10,20,0.0
2025-09-03,SNLK,-89814000,SH,0.20001291306177024,134446200,10,10,20,0.0
2025-09-03,SOCI,9219700,IN,0.2913593290458907,196348800,10,10,20,0.0
2025-09-03,SOFA,3392300,XA,0.536319415882504,142265000,7,10,17,0.0
2025-09-03,SOHO,0,XC,0.6003693159959991,3901500,5,4,9,0.0
2025-09-03,SOLA,69186000,YP,0.3658906027658888,455915900,10,10,20,0.0
2025-09-03,SONA,-6878000,CP,0.5969762510820726,463425500,10,10,20,0.0
2025-09-03,SOTS,0,XL,0.5207463102199944,374000,6,2,8,0.0
2025-09-03,SOUL,0,XC,0.6716216560927348,92152200,10,10,20,0.0
2025-09-03,SPMA,0,AT,0.6431547199004741,24608000,4,8,12,0.0
2025-09-03,SPRE,-556600,DR,0.40122338003589403,76927000,10,10,20,0.0
2025-09-03,SPTO,-736000,CC,0.42478240872624956,133457500,10,7,17,0.0
2025-09-03,SRAJ,4632500,ZP,0.2566303095226502,632450000,10,10,20,0.0
2025-09-03,SRSN,4633400,OD,0.21784023095808594,151327400,10,10,20,0.0
2025-09-03,SRTG,-875781500,YP,0.2626268204659857,2244587000,10,10,20,0.0
2025-09-03,SSIA,-2374050000,KK,0.20615877819552156,4246997000,10,10,20,0.0
2025-09-03,SSMS,41475000,YU,0.2976235173879132,276648500,10,10,20,0.0
2025-09-03,SSTM,8382000,NI,0.8661924974544492,334832600,6,10,16,0.0
2025-09-03,STAA,-288203500,AK,0.18311061716792965,611427500,10,10,20,0.0
2025-09-03,STAR,0,DR,0.3679659368675585,4200000,4,7,11,0.0
2025-09-03,STRK,-65790900,PD,0.23967777398738171,1422529700,10,10,20,0.0
2025-09-03,STTP,0,DH,0.5004511278195489,4160000,3,3,6,0.0
2025-09-03,SULI,-23200,KK,0.6652417431524175,73639600,10,8,18,0.0
2025-09-03,SUNI,-25267000,YP,0.1964289553458173,45682500,10,10,20,0.0
2025-09-03,SURE,0,YP,0.9997441146366428,3907000,2,3,5,0.0
2025-09-03,SURI,-314569700,LG,0.26475154948684315,1714910900,10,10,20,0.0
2025-09-03,SWID,3337800,GR,0.550753925073838,44287500,9,10,19,0.0
2025-09-03,TALF,0,XL,0.47253076031265195,10108000,6,4,10,0.0
2025-09-03,TAMA,0,XL,0.4424837566450089,19776900,6,8,14,0.0
2025-09-03,TAMU,6714900,OD,0.3146007542220036,62167500,5,10,15,0.0
2025-09-03,TAPG,-318829500,YP,0.240729790292362,1286038000,10,10,20,0.0
2025-09-03,TARA,405000,OD,0.34202421410365336,19323000,4,10,14,0.0
2025-09-03,TAXI,336385900,YB,0.4983725079916257,1307151000,10,10,20,0.0
2025-09-03,TAYS,-323585200,YP,0.17688934649721083,320614700,10,10,20,0.0
2025-09-03,TBIG,-216405500,AK,0.44451684084578824,1454848500,10,6,16,0.0
2025-09-03,TBLA,114810000,GR,0.35924380385916627,684619000,10,10,20,0.0
2025-09-03,TBMS,0,XL,0.398715576357897,3663000,4,8,12,0.0
2025-09-03,TCID,0,CP,0.627845176198729,5434000,6,3,9,0.0
2025-09-03,TCPI,17205000,CC,0.35354143047705744,953465000,10,10,20,0.0
2025-09-03,TEBE,251342500,NI,0.6181469527521766,3181641000,10,10,20,0.0
2025-09-03,TFAS,0,XL,0.4398601742897937,5360400,9,5,14,0.0
2025-09-03,TGKA,0,KI,0.9523809523809523,11600000,2,1,3,0.0
2025-09-03,TIFA,0,XL,0.9777090846642624,5693200,3,6,9,0.0
2025-09-03,TINS,1814770000,SQ,0.2090906591299878,2342181500,10,10,20,0.0
2025-09-03,TIRA,-163500,PD,0.3120088328895239,7206000,10,6,16,0.0
2025-09-03,TKIM,1179790000,MG,0.2526562131454988,3288500000,10,10,20,0.0
2025-09-03,TLDN,-101210500,XL,0.552483539352101,1452729500,10,10,20,0.0
2025-09-03,TLKM,4227891000,AK,0.3741016874008884,49413588000,10,10,20,0.0
2025-09-03,TMAS,9703900,OD,0.5710700807672824,544595900,10,10,20,0.0
2025-09-03,TNCA,-2814500,NI,0.20080971857958468,24631300,10,9,19,0.0
2025-09-03,TOBA,-219584500,XL,0.27249459487365274,6296973500,10,10,20,0.0
2025-09-03,TOOL,-31534200,CC,0.3492242538956687,162879100,10,10,20,0.0
2025-09-03,TOSK,167679000,PD,0.2905888603947742,801103100,10,10,20,0.0
2025-09-03,TOTL,-36479000,YU,0.22287581804106113,139052000,10,9,19,0.0
2025-09-03,TOTO,-76600,PD,0.3259190949166531,43753400,10,8,18,0.0
2025-09-03,TOWR,-2451934500,AG,0.1854441850445104,2583716500,10,10,20,0.0
2025-09-03,TPIA,-2186485000,BK,0.23097346619532144,6324005000,10,10,20,0.0
2025-09-03,TPMA,-9337500,YP,0.25468982680797464,275186500,10,10,20,0.0
2025-09-03,TRGU,-1036100,YP,0.2919387521598254,44014000,10,5,15,0.0
2025-09-03,TRIM,304400,RF,0.8465534121772472,330644800,4,10,14,0.0
2025-09-03,TRIN,-906200,KI,0.33579725226122814,31850000,10,8,18,0.0
2025-09-03,TRIS,290800,SQ,0.48417160829210076,101464600,10,10,20,0.0
2025-09-03,TRJA,0,OD,0.40479066705948197,36960100,9,8,17,0.0
2025-09-03,TRON,-11727200,EP,0.36566451888101215,93439900,10,8,18,0.0
2025-09-03,TRST,0,XL,0.9255773092369478,2950000,2,2,4,0.0
2025-09-03,TRUE,43436200,XL,0.438426205168654,274032600,10,10,20,0.0
2025-09-03,TRUK,1431800,LG,0.6659937828972462,69844100,5,10,15,0.0
2025-09-03,TRUS,0,EP,0.8244752669694366,1343400,3,5,8,0.0
2025-09-03,TSPC,-495000,AO,0.49603402965605875,517175000,10,9,19,0.0
2025-09-03,TUGU,-204761500,YP,0.23558513770926623,401019500,10,4,14,0.0
2025-09-03,TYRE,-1597100,PD,0.28060127011348934,30629200,10,8,18,0.0
2025-09-03,UANG,6087000,MG,0.43754016134303203,238318500,8,10,18,0.0
2025-09-03,UCID,-48043400,YU,0.5306172073883598,1048307200,10,10,20,0.0
2025-09-03,UFOE,0,XC,0.6375565696540494,13468000,4,7,11,0.0
2025-09-03,ULTJ,-21413500,PD,0.3352337447677202,631573000,10,10,20,0.0
2025-09-03,UNIC,0,XL,1.0,8045000,1,4,5,0.0
2025-09-03,UNIQ,-50637200,AT,0.650567902849365,3979052200,10,10,20,0.0
2025-09-03,UNSP,0,BQ,0.5928169623539593,46854000,7,7,14,0.0
2025-09-03,UNTD,-3725600,XC,0.23187885588415955,67119700,10,10,20,0.0
2025-09-03,UNTR,-1234105000,ZP,0.33006461780492063,17822920000,10,10,20,0.0
2025-09-03,UNVR,-11199500,ZP,0.38892669480394976,2785043000,10,10,20,0.0
2025-09-03,URBN,7089200,YP,0.8973941271699756,106153200,9,10,19,0.0
2025-09-03,UVCR,-547700,LS,0.29221226271565315,17190000,10,9,19,0.0
2025-09-03,VAST,-23517900,AZ,0.3058681478231875,180161600,10,10,20,0.0
2025-09-03,VERN,93481500,AT,0.1674418670013719,154895900,10,10,20,0.0
2025-09-03,VICI,-123000,AZ,0.32433514753262827,44545000,10,10,20,0.0
2025-09-03,VICO,20400,OD,0.32418349004873426,24978500,9,10,19,0.0
2025-09-03,VINS,0,XL,0.35015127503241605,1215200,10,4,14,0.0
2025-09-03,VISI,10136400,AO,0.2629593745887307,180026800,10,10,20,0.0
2025-09-03,VIVA,7560900,OD,0.49504659028783243,255443100,5,10,15,0.0
2025-09-03,VKTR,173295200,XL,0.3790582058813599,1167641800,10,10,20,0.0
2025-09-03,VOKS,-109400,EP,0.2812458529076094,16954400,10,10,20,0.0
2025-09-03,VRNA,-2585200,DR,0.2806342251894095,25313600,10,10,20,0.0
2025-09-03,VTNY,-107935000,SA,0.2331730893862475,166401900,10,10,20,0.0
2025-09-03,WAPO,4661400,CP,0.3289609702348299,356379900,10,10,20,0.0
2025-09-03,WEGE,1662198400,XL,0.3194996368170626,3940622000,10,10,20,0.0
2025-09-03,WEHA,-2489200,XL,0.22310413274992022,16499800,10,6,16,0.0
2025-09-03,WGSH,0,XL,0.6159771909626024,105452400,5,6,11,0.0
2025-09-03,WIDI,7650000,XC,0.3475792317803418,89483300,10,10,20,0.0
2025-09-03,WIFI,-14153981000,CC,0.15270425546990363,9506475000,10,10,20,0.0
2025-09-03,WIIM,-46335000,YP,0.20930185345552246,164955500,10,5,15,0.0
2025-09-03,WINE,-231600,YJ,0.35856044605896764,21221400,10,2,12,0.0
2025-09-03,WINR,-25233000,RG,0.26316828295853784,60000000,10,4,14,0.0
2025-09-03,WINS,-62926400,DX,0.43725162059646794,340134800,10,5,15,0.0
2025-09-03,WIRG,-1799833000,RF,0.16272278103880164,3517248600,10,10,20,0.0
2025-09-03,WMUU,-99718900,XL,0.3023429167189167,324765000,10,10,20,0.0
2025-09-03,WOMF,0,YB,0.974708286441983,82280000,6,10,16,0.0
2025-09-03,WOOD,247169000,LG,0.9358848986480488,5007372600,10,10,20,0.0
2025-09-03,WSBP,28053000,MG,0.7386086436656051,1801287000,8,10,18,0.0
2025-09-03,WTON,-261500700,YP,0.2800468222673644,1968989100,10,10,20,0.0
2025-09-03,YELO,-4938900,AT,0.4332808319325332,198808700,10,10,20,0.0
2025-09-03,YULE,0,RB,1.0,230040000,1,1,2,0.0
2025-09-03,ZATA,3129600,XL,0.5238158013990393,152580000,10,10,20,0.0
2025-09-03,ZINC,4930300,XL,0.7191704185643809,239554300,10,10,20,0.0
2025-09-03,ZONE,0,PC,0.32382016513900463,8549500,10,7,17,0.0
2025-09-03,ZYRX,5542900,MG,0.6061309524923882,97130000,9,10,19,0.0
