broker_source_date,symbol,total_net_value,top_buyer,top_buyer_concentration,top_buyer_net_value,num_buyers,num_sellers,num_brokers,retail_broker_ratio
2025-09-04,AADI,6809832500,AK,0.3226688761075931,15865890000,10,10,20,0.0
2025-09-04,AALI,267255000,YU,0.312793191677184,1133867500,10,10,20,0.0
2025-09-04,ABBA,0,AK,0.7756614668620184,37800000,9,5,14,0.0
2025-09-04,ABMM,15616000,AK,0.4563575036096649,228516000,10,10,20,0.0
2025-09-04,ACES,26933200,ZP,0.28804567986489404,3921478600,10,10,20,0.0
2025-09-04,ACRO,-27663500,CC,0.3194152512769314,197781700,10,10,20,0.0
2025-09-04,ACST,-299609800,CC,0.23881568910200268,316980900,10,9,19,0.0
2025-09-04,ADCP,-285525600,PD,0.26882721524124015,597876700,10,10,20,0.0
2025-09-04,ADES,0,XL,0.5815985412551284,19137500,5,3,8,0.0
2025-09-04,ADHI,448943200,ZP,0.2815706493591282,1119605600,10,10,20,0.0
2025-09-04,ADMF,0,PD,0.5133359986292764,89880000,10,6,16,0.0
2025-09-04,ADMG,-1252500,KK,0.46472862099450135,50938300,10,7,17,0.0
2025-09-04,ADMR,-1574454000,YP,0.37078232477850176,8310173500,10,10,20,0.0
2025-09-04,ADRO,10728786000,ZP,0.354069148526497,29536960000,10,10,20,0.0
2025-09-04,AEGS,-66751300,XC,0.2582636473408186,171963300,10,10,20,0.0
2025-09-04,AGAR,0,OD,0.9682266678736309,10696000,5,7,12,0.0
2025-09-04,AGII,-10932000,PD,0.36489338195493853,123028000,10,10,20,0.0
2025-09-04,AGRO,-45338800,NI,0.41625796797648007,353621800,10,10,20,0.0
2025-09-04,AGRS,-40405300,YP,0.3267413522584556,195356400,10,7,17,0.0
2025-09-04,AHAP,-40341600,CC,0.1658531047047026,50543800,10,10,20,0.0
2025-09-04,AIMS,0,YJ,0.5457402234636871,3126000,5,3,8,0.0
2025-09-04,AISA,63825700,CC,0.4189858458478325,414206600,10,10,20,0.0
2025-09-04,AKPI,0,YP,0.35973597359735976,2071000,6,2,8,0.0
2025-09-04,AKRA,1210093000,DP,0.2614815698569828,3530782500,10,10,20,0.0
2025-09-04,AKSI,-48200,XL,0.39491634221403676,13165800,10,6,16,0.0
2025-09-04,ALDO,0,CC,0.8630519518296585,14835000,2,7,9,0.0
2025-09-04,ALII,0,KI,0.9376413515635799,637635500,6,8,14,0.0
2025-09-04,ALKA,0,YP,0.4305222088835534,573800,4,2,6,0.0
2025-09-04,AMAG,0,XL,0.5087911535561699,10122400,5,7,12,0.0
2025-09-04,AMAN,221400,PD,0.4565739763965408,54057400,7,10,17,0.0
2025-09-04,AMAR,-1985200,XL,0.3982791838389596,54223600,10,10,20,0.0
2025-09-04,AMFG,0,AO,0.5817440675498617,11988000,7,7,14,0.0
2025-09-04,AMIN,-220400,GR,0.5509478929693424,45772200,10,8,18,0.0
2025-09-04,AMMN,1226610000,BK,0.6446740283666507,64743982500,10,10,20,0.0
2025-09-04,AMMS,71730700,CP,0.40951752991020623,288679800,10,10,20,0.0
2025-09-04,AMOR,0,CC,0.5079024116657319,18111800,10,4,14,0.0
2025-09-04,AMRT,-4830356000,BQ,0.29586637374023084,9932833000,10,8,18,0.0
2025-09-04,ANDI,-38781200,XL,0.20270378310039622,76062000,10,2,12,0.0
2025-09-04,ANJT,0,YP,0.5512293709419619,781823500,7,8,15,0.0
2025-09-04,ANTM,26845160000,BK,0.2864635163659357,45505493000,10,10,20,0.0
2025-09-04,APEX,-5266800,PD,0.2477752452647468,148191500,10,10,20,0.0
2025-09-04,APIC,-50606500,BR,0.22113522602247107,273950500,10,10,20,0.0
2025-09-04,APII,0,PD,0.495775119216933,1777800,3,5,8,0.0
2025-09-04,APLI,0,NI,0.7785372975842846,2346200,4,3,7,0.0
2025-09-04,APLN,-100012300,CD,0.2652002992239132,197289000,10,7,17,0.0
2025-09-04,ARCI,-3650887000,YU,0.22689501122385322,5916197000,10,10,20,0.0
2025-09-04,AREA,-459000,CD,0.2765422847193141,50188000,10,9,19,0.0
2025-09-04,ARGO,0,XC,0.45215074632132396,12813500,6,6,12,0.0
2025-09-04,ARII,0,XL,0.7682270485420092,8878400,4,8,12,0.0
2025-09-04,ARKA,21226200,MG,0.3586884949721175,116737000,10,10,20,0.0
2025-09-04,ARKO,12984500,GA,0.5673028525914164,269940000,10,10,20,0.0
2025-09-04,ARNA,50000,XL,0.44452740175323513,93178500,10,10,20,0.0
2025-09-04,ARTA,0,YP,0.32277425808602866,968000,7,6,13,0.0
2025-09-04,ARTO,-438784000,AK,0.2742923296317135,762446000,10,10,20,0.0
2025-09-04,ASBI,0,PD,0.6231652173913044,1791600,5,5,10,0.0
2025-09-04,ASDM,0,XL,0.7732127151652217,3077000,6,3,9,0.0
2025-09-04,ASGR,222000,ZP,0.4896655278183202,297249500,10,10,20,0.0
2025-09-04,ASHA,1533000,OD,0.2325096939196436,47346600,9,10,19,0.0
2025-09-04,ASII,4722450000,CC,0.28166577483806426,11226422500,10,10,20,0.0
2025-09-04,ASJT,0,DH,0.831442301274778,4983000,2,5,7,0.0
2025-09-04,ASLC,-1276227700,IN,0.21595924587948875,1098155400,10,10,20,0.0
2025-09-04,ASMI,0,MG,0.8765432098765432,43856700,3,9,12,0.0
2025-09-04,ASPI,0,PD,0.8793498723025939,964963200,7,8,15,0.0
2025-09-04,ASRI,77329800,AT,0.3517423390668873,698656100,10,10,20,0.0
2025-09-04,ASRM,0,XL,0.9082602608503426,9860800,5,4,9,0.0
2025-09-04,ASSA,-146018500,YP,0.4581971959266185,924655000,10,9,19,0.0
2025-09-04,ATAP,0,YP,0.37874975808012384,11154900,9,7,16,0.0
2025-09-04,ATIC,-2000,CP,0.5759936769059708,42996200,10,9,19,0.0
2025-09-04,ATLA,-154217100,CC,0.2743279908246405,485046700,10,10,20,0.0
2025-09-04,AUTO,-82934000,TP,0.6548016960362829,2661156000,10,10,20,0.0
2025-09-04,AVIA,-16452000,BB,0.6374602078646934,556165800,10,10,20,0.0
2025-09-04,AWAN,-3843200,AK,0.5786481951608979,185536600,10,9,19,0.0
2025-09-04,AXIO,-230100,XL,0.3703230429330626,21706300,10,6,16,0.0
2025-09-04,AYAM,28292000,XA,0.9165607447576453,7272776700,7,10,17,0.0
2025-09-04,AYLS,0,XC,0.6659054599784027,72025400,9,9,18,0.0
2025-09-04,BABP,-61007500,YP,0.25522128338670735,379679100,10,10,20,0.0
2025-09-04,BABY,-263000,CC,0.5340420571438532,98038800,10,10,20,0.0
2025-09-04,BACA,599200,SQ,0.5821787525292094,126772800,7,10,17,0.0
2025-09-04,BAIK,689000,YP,0.6235234657739791,51445300,9,10,19,0.0
2025-09-04,BAJA,-49200,XC,0.37804922845654576,13379200,10,6,16,0.0
2025-09-04,BALI,-139500,XC,0.4635328661255921,25101000,10,6,16,0.0
2025-09-04,BANK,568000,BK,0.6114997074624804,584247000,10,10,20,0.0
2025-09-04,BAPA,134039800,XL,0.8949463893079377,1106332100,10,10,20,0.0
2025-09-04,BAPI,12010600,BQ,0.3743882691615689,95719100,10,10,20,0.0
2025-09-04,BATA,0,AO,0.9636363636363636,270300,3,1,4,0.0
2025-09-04,BATR,7840300,XL,0.45806959839776346,688135100,10,10,20,0.0
2025-09-04,BAUT,819000,XC,0.726926850835586,112459800,9,10,19,0.0
2025-09-04,BAYU,0,XL,0.481712510646826,38458000,8,4,12,0.0
2025-09-04,BBCA,-34090992500,AK,0.3928486141190014,116260682500,10,10,20,0.0
2025-09-04,BBHI,-26164500,CC,0.7283600284671207,1978822000,10,10,20,0.0
2025-09-04,BBKP,-330478200,CP,0.2738420876825437,960651900,10,10,20,0.0
2025-09-04,BBLD,0,ZP,0.8587897598655807,92000000,6,6,12,0.0
2025-09-04,BBMD,0,XL,0.7137577311811736,9463000,4,2,6,0.0
2025-09-04,BBNI,-4071798000,HP,0.21654298674307546,6142917000,10,10,20,0.0
2025-09-04,BBRI,-9058993000,MG,0.3069046051807449,42348061000,10,10,20,0.0
2025-09-04,BBRM,-171300,YP,0.4343953326389377,169947400,10,10,20,0.0
2025-09-04,BBSI,0,LG,0.9914539044973828,46405000,2,5,7,0.0
2025-09-04,BBSS,0,YP,0.6983820370570691,9038600,6,7,13,0.0
2025-09-04,BBTN,198181500,NI,0.796605711663318,6410418000,10,10,20,0.0
2025-09-04,BBYB,-341360800,ZP,0.22921372344812033,955142800,10,10,20,0.0
2025-09-04,BCAP,-40896000,YP,0.3921053976563895,1636412000,10,10,20,0.0
2025-09-04,BCIP,-438500,XL,0.25011290056479035,56546500,10,9,19,0.0
2025-09-04,BDKR,-29722600,SH,0.3139133617890434,271415300,10,9,19,0.0
2025-09-04,BDMN,2289000,RF,0.34061768739389553,267250000,10,10,20,0.0
2025-09-04,BEEF,253102600,AG,0.73743657949921,1997586200,10,10,20,0.0
2025-09-04,BEER,1168300,OD,0.4956642324950635,30774900,5,10,15,0.0
2025-09-04,BEKS,-166248600,XL,0.2659008545587305,565429100,10,8,18,0.0
2025-09-04,BELI,-188200,EP,0.5081046862245323,18300000,10,3,13,0.0
2025-09-04,BELL,-24833900,XL,0.6257423852900853,1445203600,10,10,20,0.0
2025-09-04,BESS,-811000,KK,0.3617641845400197,11225000,10,6,16,0.0
2025-09-04,BEST,9249300,PD,0.18098141940265822,112807800,10,10,20,0.0
2025-09-04,BFIN,-354680000,BB,0.5268772060218615,2016073500,10,10,20,0.0
2025-09-04,BGTG,-26262600,AZ,0.42741184759016043,507118900,10,10,20,0.0
2025-09-04,BHAT,4013000,BQ,0.4068139806046128,178810000,10,10,20,0.0
2025-09-04,BHIT,32756900,YU,0.33035782155557974,176882200,10,10,20,0.0
2025-09-04,BIKE,-89563500,PC,0.16983925389748988,313991000,10,10,20,0.0
2025-09-04,BIMA,0,AZ,0.2899361942275355,2517400,6,7,13,0.0
2025-09-04,BINA,0,RS,1.0,29983000,1,4,5,0.0
2025-09-04,BINO,0,SQ,0.6254503604861322,15814700,6,9,15,0.0
2025-09-04,BIPI,-313954100,KI,0.2648142937541207,617301000,10,10,20,0.0
2025-09-04,BIPP,0,YB,0.48211425520555257,632100,5,2,7,0.0
2025-09-04,BIRD,-49882500,PD,0.39605742855280246,394895000,10,8,18,0.0
2025-09-04,BISI,0,CC,0.5081772136449625,8327500,5,7,12,0.0
2025-09-04,BJBR,-634722500,NI,0.20757383660411824,777517000,10,6,16,0.0
2025-09-04,BJTM,-19973500,PD,0.41591603516090336,348267500,10,8,18,0.0
2025-09-04,BKDP,0,XL,0.8530073432658432,84403200,9,3,12,0.0
2025-09-04,BKSL,-1920428100,LG,0.20596749530090736,1822254800,10,10,20,0.0
2025-09-04,BKSW,-2071500,XL,0.44997417999056855,100381500,10,9,19,0.0
2025-09-04,BLES,-5408100,XL,0.28123483885673833,81676700,10,10,20,0.0
2025-09-04,BLTA,2785300,YP,0.31883146054619504,156775200,10,10,20,0.0
2025-09-04,BLUE,0,YB,0.4346381679389313,7117200,6,8,14,0.0
2025-09-04,BMAS,0,NI,0.4244521499866635,15117500,7,8,15,0.0
2025-09-04,BMBL,864200,XL,0.4377497722605232,81210900,7,10,17,0.0
2025-09-04,BMHS,-19489000,YP,0.458511393643812,241388000,10,4,14,0.0
2025-09-04,BMRI,25017315000,YU,0.6985196857115198,131123285000,10,10,20,0.0
2025-09-04,BMSR,0,YP,0.6429587482219061,3796800,9,5,14,0.0
2025-09-04,BMTR,22119000,BB,0.23562035441663529,770954300,10,10,20,0.0
2025-09-04,BNBA,1386000,OD,0.5110495564022133,75920500,5,10,15,0.0
2025-09-04,BNBR,-1176312100,CP,0.27380173648681033,1571607100,10,5,15,0.0
2025-09-04,BNGA,-8628000,BK,0.43941340575204524,655471000,10,10,20,0.0
2025-09-04,BNII,-31000,SQ,0.4321286914426551,48917400,10,10,20,0.0
2025-09-04,BNLI,3169000,ZP,0.9744598886449184,397642000,5,10,15,0.0
2025-09-04,BOAT,1024000,CP,0.20669113022193258,58230100,10,10,20,0.0
2025-09-04,BOBA,0,XL,0.9508163576267611,32448700,4,7,11,0.0
2025-09-04,BOGA,2491000,AH,0.1617057472117186,30512500,10,10,20,0.0
2025-09-04,BOLA,-8871100,RF,0.4938605603970526,176084600,10,9,19,0.0
2025-09-04,BOLT,0,XL,0.5510588235294117,1171000,2,2,4,0.0
2025-09-04,BPFI,0,YP,0.4004063295847998,5597200,6,5,11,0.0
2025-09-04,BPII,-114000,PF,0.236987596082269,14167000,10,7,17,0.0
2025-09-04,BPTR,0,XL,0.7211331823198002,9932600,7,3,10,0.0
2025-09-04,BRAM,0,CC,0.4904306220095694,512500,4,2,6,0.0
2025-09-04,BREN,-2361690000,AZ,0.20051612953691095,9228420000,10,10,20,0.0
2025-09-04,BRIS,-420141000,BK,0.638760116940304,8235363000,10,10,20,0.0
2025-09-04,BRMS,-33130222200,YP,0.37376841762890234,38485746800,10,10,20,0.0
2025-09-04,BRNA,0,YU,0.7810998781099878,10894000,5,3,8,0.0
2025-09-04,BRPT,148908000,AK,0.2815081323317036,7180605000,10,10,20,0.0
2025-09-04,BSBK,-129663500,SQ,0.24666461419863922,754887600,10,10,20,0.0
2025-09-04,BSDE,-1218814500,LG,0.21542116813908083,2282707500,10,10,20,0.0
2025-09-04,BSIM,0,OD,0.6780364372469636,6699000,6,5,11,0.0
2025-09-04,BSML,-28579500,BR,0.5574250430825324,991706700,10,10,20,0.0
2025-09-04,BSSR,1187000,IN,0.4951785649923339,357203000,10,10,20,0.0
2025-09-04,BSWD,0,CC,1.0,282000,1,1,2,0.0
2025-09-04,BTEK,16937600,YB,0.5745720634003915,458436800,8,10,18,0.0
2025-09-04,BTON,0,YP,0.47780517879161527,1860000,6,7,13,0.0
2025-09-04,BTPN,0,OD,0.33509374174808554,2538000,8,6,14,0.0
2025-09-04,BTPS,671668500,OD,0.5415107569392935,4312452500,10,10,20,0.0
2025-09-04,BUAH,0,YP,0.4183370324417576,42315000,6,10,16,0.0
2025-09-04,BUDI,0,OD,0.4163013596849692,1120600,7,3,10,0.0
2025-09-04,BUKA,292249100,YU,0.6090013675782858,13767140700,10,10,20,0.0
2025-09-04,BUKK,0,GR,0.9444230027016596,4894000,2,5,7,0.0
2025-09-04,BULL,175233400,KI,0.7688312101053844,6391374500,10,10,20,0.0
2025-09-04,BUMI,-9339922900,MG,0.6034681339360951,79919551000,10,10,20,0.0
2025-09-04,BUVA,-1510703200,XL,0.25163967940996795,3409640000,10,10,20,0.0
2025-09-04,BVIC,-9160300,YP,0.2226348507040954,158292800,10,10,20,0.0
2025-09-04,BYAN,0,IF,0.8192901652668654,98280000,5,5,10,0.0
2025-09-04,CAKK,341300,KK,0.4079758455579615,33442800,9,10,19,0.0
2025-09-04,CAMP,9708200,YP,0.5622336709174846,86104400,10,10,20,0.0
2025-09-04,CANI,0,XL,0.5995104500094144,13691200,5,2,7,0.0
2025-09-04,CARE,46707600,PO,0.35713171240905944,413836800,10,10,20,0.0
2025-09-04,CARS,184397800,MG,0.19258627155755562,1467631800,10,10,20,0.0
2025-09-04,CASA,60962000,PO,0.553155968988048,653400000,10,10,20,0.0
2025-09-04,CASH,-6801400,CC,0.2153054784979791,30944500,10,9,19,0.0
2025-09-04,CASS,-2484000,KK,0.5427187485355702,127394000,10,7,17,0.0
2025-09-04,CBPE,0,PD,0.3321061964278045,5412700,10,4,14,0.0
2025-09-04,CBRE,468536600,CP,0.4519016512084103,2576860800,4,10,14,0.0
2025-09-04,CBUT,0,BQ,0.4815100995910212,30846500,9,4,13,0.0
2025-09-04,CCSI,787400,XL,0.6400093494300444,78311800,7,10,17,0.0
2025-09-04,CEKA,0,OD,0.532414437565705,4558000,6,4,10,0.0
2025-09-04,CENT,23463100,CC,0.2675255412531056,117659900,10,10,20,0.0
2025-09-04,CFIN,1684200,YP,0.4707734783975507,68886400,10,10,20,0.0
2025-09-04,CGAS,-193050800,YJ,0.44835163302248604,880662500,10,10,20,0.0
2025-09-04,CHEM,27560100,EP,0.45136131980675903,244898000,10,10,20,0.0
2025-09-04,CHIP,0,XL,0.41448872849433305,24923000,6,8,14,0.0
2025-09-04,CINT,0,KK,0.5209912536443149,4646200,10,7,17,0.0
2025-09-04,CITA,-2069000,XL,0.47126615090525137,188350000,10,9,19,0.0
2025-09-04,CITY,-1696500,XL,0.34608544511928935,60093100,10,10,20,0.0
2025-09-04,CLAY,447500,PS,0.4299252390266181,86605000,3,10,13,0.0
2025-09-04,CLEO,-237165500,XL,0.21869225454704694,392032000,10,10,20,0.0
2025-09-04,CLPI,0,DH,0.8096579139458265,82081500,3,6,9,0.0
2025-09-04,CMNP,-807000,RS,0.24208934806868498,13450000,10,8,18,0.0
2025-09-04,CMNT,-772178500,KI,0.31911170342318496,1091400000,10,10,20,0.0
2025-09-04,CMPP,0,EP,0.827485380116959,2631900,5,6,11,0.0
2025-09-04,CMRY,125853000,KZ,0.9369555185111934,1293305000,3,10,13,0.0
2025-09-04,CNKO,964781100,YJ,0.5222248194610104,3770495000,10,10,20,0.0
2025-09-04,CNMA,-59684800,PD,0.710929933957264,1684438000,10,10,20,0.0
2025-09-04,COAL,11292600,XL,0.36096816674823157,582326300,10,10,20,0.0
2025-09-04,COCO,-210142000,GR,0.2842958416917103,695642500,10,10,20,0.0
2025-09-04,CPIN,4519421000,PD,0.5906086276677113,13020533000,10,10,20,0.0
2025-09-04,CPRO,-1193836500,OD,0.17080465165540543,794416500,10,10,20,0.0
2025-09-04,CRAB,0,EP,0.6763857821387008,140184200,5,7,12,0.0
2025-09-04,CRSN,-627500,CP,0.4163627234574685,39555000,10,3,13,0.0
2025-09-04,CSAP,0,DX,0.23642114659404775,7310000,7,5,12,0.0
2025-09-04,CSIS,1440000,PD,0.6108132270046593,119977400,9,10,19,0.0
2025-09-04,CSMI,0,YP,0.3470488818135229,31828200,9,5,14,0.0
2025-09-04,CSRA,66635000,YB,0.7162118612677497,803406000,10,10,20,0.0
2025-09-04,CTRA,-1627228500,YU,0.26629810345734395,3999928000,10,10,20,0.0
2025-09-04,CTTH,0,YB,0.5555555555555556,294000,6,3,9,0.0
2025-09-04,CUAN,2966648500,ZP,0.5026922298809529,12590319500,10,10,20,0.0
2025-09-04,CYBR,68162000,AK,0.6978447500671232,6163812500,10,10,20,0.0
2025-09-04,DAAZ,-4081000,YP,0.27245003954904556,28589000,10,9,19,0.0
2025-09-04,DADA,5002200,nan,0.7941003265699449,249194400,6,10,16,0.0
2025-09-04,DART,0,PD,0.5624136569962502,2279800,4,7,11,0.0
2025-09-04,DAYA,0,PD,0.7575379649328736,5163000,3,4,7,0.0
2025-09-04,DCII,0,PD,0.33254531792200337,98467500,6,6,12,0.0
2025-09-04,DEFI,0,XL,0.8817391527007823,13774000,4,5,9,0.0
2025-09-04,DEPO,-20000,RF,0.6741333678489617,100000000,10,8,18,0.0
2025-09-04,DEWA,-1337456200,CC,0.17999413586050234,2334220400,10,10,20,0.0
2025-09-04,DEWI,-32700,XA,0.5223415178573612,1068200000,10,10,20,0.0
2025-09-04,DFAM,-13762300,XL,0.33228712482052675,78015800,10,10,20,0.0
2025-09-04,DGIK,-44584700,YP,0.2292190560946172,87779300,10,10,20,0.0
2025-09-04,DGNS,29600,YJ,0.8482610060510278,39181600,5,10,15,0.0
2025-09-04,DIGI,-83200,YP,0.703720368968973,27525600,10,5,15,0.0
2025-09-04,DILD,-9502900,XL,0.220005586145469,138395900,10,10,20,0.0
2025-09-04,DIVA,-4862300,XL,0.47111182157539955,104623100,10,9,19,0.0
2025-09-04,DKFT,-3310301000,XL,0.2145845537631165,4216369000,10,10,20,0.0
2025-09-04,DLTA,-979000,YP,0.42495969886665846,129830500,10,4,14,0.0
2025-09-04,DMAS,-41006900,AI,0.24211147986143225,557000000,10,10,20,0.0
2025-09-04,DMMX,20231800,XL,0.26828927019130877,297199800,10,10,20,0.0
2025-09-04,DMND,0,OD,0.49288082699434366,7581000,9,5,14,0.0
2025-09-04,DNAR,142300,XL,0.32637778649211185,34623200,10,10,20,0.0
2025-09-04,DNET,0,XL,0.9468722239734074,82607500,4,7,11,0.0
2025-09-04,DOID,-386874600,BB,0.23947355976649876,1075609000,10,10,20,0.0
2025-09-04,DOOH,531820100,YB,0.6422011334232627,3001149300,10,10,20,0.0
2025-09-04,DOSS,-28000,CC,0.5973258081345656,48430400,10,9,19,0.0
2025-09-04,DPNS,0,PD,0.6397061132217652,4074800,7,8,15,0.0
2025-09-04,DPUM,-22303700,XL,0.6286404431344714,505460800,10,10,20,0.0
2025-09-04,DRMA,-4541500,BK,0.5532058004944317,361060000,10,10,20,0.0
2025-09-04,DSFI,57205000,YP,0.20444350687141222,85574900,10,10,20,0.0
2025-09-04,DSNG,923797500,BB,0.415244809360411,7413036500,10,10,20,0.0
2025-09-04,DSSA,-5075652500,AK,0.3167128069840995,75181307500,10,10,20,0.0
2025-09-04,DUTI,0,CC,0.3583899889892864,20506000,10,10,20,0.0
2025-09-04,DVLA,-8053500,PD,0.215611966210065,20368000,10,4,14,0.0
2025-09-04,DWGL,0,CC,0.8469594192550279,7117000,5,7,12,0.0
2025-09-04,DYAN,7506900,RB,0.749099813671341,130378800,10,10,20,0.0
2025-09-04,EAST,-589600,CC,0.5115829463928758,216640900,10,10,20,0.0
2025-09-04,ECII,-1175800,CC,0.3314704364648842,18178800,10,4,14,0.0
2025-09-04,EDGE,0,CC,0.3284366914280945,11805000,7,7,14,0.0
2025-09-04,EKAD,0,KK,0.5703381908166071,5185800,5,7,12,0.0
2025-09-04,ELIT,-4995600,IF,0.3358378638453417,237740900,10,10,20,0.0
2025-09-04,ELPI,-13187400,BR,0.36233192699930555,172706600,10,10,20,0.0
2025-09-04,ELSA,89946800,ZP,0.2722281429359295,792191600,10,10,20,0.0
2025-09-04,ELTY,-165982900,YP,0.2081645735262412,306940100,10,3,13,0.0
2025-09-04,EMDE,-265000,XL,0.38615032502003177,63758400,10,10,20,0.0
2025-09-04,EMTK,4561437500,AZ,0.4270039043330568,32252996500,10,10,20,0.0
2025-09-04,ENAK,-27830000,OD,0.2559298232816005,140334000,10,6,16,0.0
2025-09-04,ENRG,-6502153500,YU,0.3971798248121264,18686586500,10,10,20,0.0
2025-09-04,ENZO,0,YP,0.6433242754800879,4948000,7,8,15,0.0
2025-09-04,EPAC,1057000,XL,0.6968827923488183,129955400,10,10,20,0.0
2025-09-04,EPMT,-229000,XA,0.5846621108580107,115500000,10,2,12,0.0
2025-09-04,ERAA,92410000,DP,0.5940152915597829,5992051200,10,10,20,0.0
2025-09-04,ERAL,-28680000,DH,0.2527587404367444,338888000,10,10,20,0.0
2025-09-04,ERTX,4810600,CP,0.35653158842168203,133809300,10,10,20,0.0
2025-09-04,ESIP,0,OD,0.4380781230500437,8775800,8,8,16,0.0
2025-09-04,ESSA,4554941000,LG,0.49407632674358576,12185608500,10,10,20,0.0
2025-09-04,ESTA,61500,XL,0.4952274761018707,48811700,10,10,20,0.0
2025-09-04,ESTI,0,AT,0.8227693886056875,20530400,7,9,16,0.0
2025-09-04,EURO,25800,II,0.6180627593360996,5719800,5,10,15,0.0
2025-09-04,EXCL,44472000,NI,0.34031412059886773,5393403000,10,10,20,0.0
2025-09-04,FAPA,0,CC,0.49886390612812426,36775000,4,2,6,0.0
2025-09-04,FAST,2104600,NI,0.2854226389624716,78656200,10,10,20,0.0
2025-09-04,FILM,5889053000,IF,0.8415183161266504,35747948000,10,10,20,0.0
2025-09-04,FIRE,-24184700,XL,0.3736625368089948,142931600,10,10,20,0.0
2025-09-04,FITT,-4472400,CC,0.32970614381649116,178839800,10,10,20,0.0
2025-09-04,FMII,0,KK,0.24584465214788895,2135800,9,4,13,0.0
2025-09-04,FOLK,0,YP,0.5044023241299372,54309200,8,7,15,0.0
2025-09-04,FOOD,0,LG,1.0,7729000,1,7,8,0.0
2025-09-04,FORU,5861000,LG,0.8099391254165348,217537500,5,10,15,0.0
2025-09-04,FPNI,0,XL,0.45766010689239706,31109400,9,8,17,0.0
2025-09-04,FUJI,-297813800,CP,0.9349272063306607,40020868900,10,4,14,0.0
2025-09-04,FUTR,-1908130600,XL,0.3388026323421082,4823829800,10,10,20,0.0
2025-09-04,FWCT,-441600,XL,0.6881954494340086,85740000,10,9,19,0.0
2025-09-04,GDST,-300,YP,0.24860928715822403,3369700,10,7,17,0.0
2025-09-04,GDYR,0,YP,0.7018947368421052,1667000,4,2,6,0.0
2025-09-04,GEMA,11334000,PD,0.28458765246475193,173680600,10,10,20,0.0
2025-09-04,GEMS,-37615000,NI,0.19094546729367393,197440000,10,6,16,0.0
2025-09-04,GGRM,888225000,RX,0.38505495093479314,2662667500,10,10,20,0.0
2025-09-04,GGRP,4230600,XL,0.5706842253497085,80239800,8,10,18,0.0
2025-09-04,GHON,0,CC,0.7356894275771031,6130500,4,5,9,0.0
2025-09-04,GIAA,13233200,XL,0.3375644531223808,251720800,10,10,20,0.0
2025-09-04,GJTL,-5285500,PD,0.472089769227574,994463000,10,10,20,0.0
2025-09-04,GLOB,0,XL,0.9928263988522238,7888800,2,4,6,0.0
2025-09-04,GLVA,0,AT,0.5603112840466926,2073600,5,4,9,0.0
2025-09-04,GMFI,0,NI,0.5545822835835936,13757800,8,5,13,0.0
2025-09-04,GOLD,0,XL,0.41139470182653926,680200,4,7,11,0.0
2025-09-04,GOLF,-63181600,IF,0.1787920439595519,104400000,10,10,20,0.0
2025-09-04,GOOD,-256000,nan,0.29179522129301055,17383000,10,10,20,0.0
2025-09-04,GOTO,8302964300,YU,0.6752768530006152,30192493600,10,10,20,0.0
2025-09-04,GPRA,-402547100,XA,0.4657841578713258,4547901100,10,9,19,0.0
2025-09-04,GPSO,-531200,KK,0.5158377508253446,858933200,10,10,20,0.0
2025-09-04,GRIA,-2044800,XC,0.525987992710555,454072600,10,10,20,0.0
2025-09-04,GRPH,-11507000,CC,0.2396783578856013,148909000,10,10,20,0.0
2025-09-04,GRPM,-1133400,XC,0.42612079942512243,53309800,10,10,20,0.0
2025-09-04,GSMF,-45044600,XL,0.38872740933598177,160592700,10,10,20,0.0
2025-09-04,GTBO,0,YP,0.7494469134200539,11551600,5,8,13,0.0
2025-09-04,GTRA,-703500,XA,0.3447569678895641,29409700,10,10,20,0.0
2025-09-04,GTSI,47223600,XL,0.24723824026264973,361483100,10,10,20,0.0
2025-09-04,GULA,-1690400,XL,0.2573962984758507,39277800,10,10,20,0.0
2025-09-04,GUNA,0,YP,0.3996832265989886,12819200,8,8,16,0.0
2025-09-04,GWSA,0,YB,0.4181804375522051,19825600,7,5,12,0.0
2025-09-04,GZCO,-774622600,XL,0.47704369157177673,2083914800,10,10,20,0.0
2025-09-04,HADE,3448500,GR,0.3311916274756574,33000000,5,10,15,0.0
2025-09-04,HAIS,-13757200,CC,0.2729600540291425,140488500,10,7,17,0.0
2025-09-04,HAJJ,-15894700,LG,0.20304768035453472,63337800,10,10,20,0.0
2025-09-04,HALO,-12585900,EP,0.21168739954052843,29145100,10,6,16,0.0
2025-09-04,HATM,-134370400,XA,0.611501747436817,1759439000,10,10,20,0.0
2025-09-04,HDFA,0,YP,0.7457028984613107,6043400,4,7,11,0.0
2025-09-04,HDIT,582300,BQ,0.2851458948971241,120000000,10,10,20,0.0
2025-09-04,HEAL,123329500,KZ,0.8215392953148649,9066490000,10,10,20,0.0
2025-09-04,HELI,0,MI,0.5709019147201945,70182000,10,3,13,0.0
2025-09-04,HERO,0,XC,0.7081835483188835,669800,4,5,9,0.0
2025-09-04,HEXA,-18745000,XL,0.402833817040655,341450000,10,10,20,0.0
2025-09-04,HILL,-618400,XA,0.6344359803688949,1016074600,10,10,20,0.0
2025-09-04,HMSP,-39259000,YP,0.30645016004761216,476292500,10,10,20,0.0
2025-09-04,HOKI,31383500,ZP,0.7529893031805218,779280000,10,10,20,0.0
2025-09-04,HOMI,-6893400,XL,0.3036969834429576,35081800,10,6,16,0.0
2025-09-04,HOPE,8197200,YB,0.37028795464780523,226443600,6,10,16,0.0
2025-09-04,HRME,0,XL,0.7400148478099481,19437600,3,7,10,0.0
2025-09-04,HRTA,1277599500,XL,0.4166042018228367,12173634500,10,10,20,0.0
2025-09-04,HRUM,283060000,BB,0.2823840654997779,5507603000,10,10,20,0.0
2025-09-04,HUMI,-14775600,XL,0.22319561316591657,1075099700,10,10,20,0.0
2025-09-04,HYGN,1177300,BQ,0.4513313795353852,77940100,4,10,14,0.0
2025-09-04,IATA,11790700,MG,0.5441662730278696,288000000,10,10,20,0.0
2025-09-04,IBFN,0,XL,0.4329867128827267,13491000,6,4,10,0.0
2025-09-04,IBOS,38404800,XL,0.35995561583774655,600302300,10,10,20,0.0
2025-09-04,IBST,0,CP,0.782608695652174,10755000,3,4,7,0.0
2025-09-04,ICBP,-514492500,KZ,0.344785014177155,5685960000,10,10,20,0.0
2025-09-04,ICON,0,CC,0.45262117857477696,25104000,9,8,17,0.0
2025-09-04,IDEA,-5887500,CC,0.28805012523390633,54569800,10,7,17,0.0
2025-09-04,IDPR,0,MU,0.7325002474005876,42931400,10,6,16,0.0
2025-09-04,IFII,1168200,PD,0.5687553097566257,136571800,10,10,20,0.0
2025-09-04,IFSH,-229500,XL,0.3906300607769543,20503000,10,6,16,0.0
2025-09-04,IGAR,0,PC,0.7125095932463545,6963000,5,4,9,0.0
2025-09-04,IKAI,745800,MG,0.4737494885433715,81512200,6,10,16,0.0
2025-09-04,IKAN,-15861300,YP,0.2912325186595038,1211889600,10,10,20,0.0
2025-09-04,IKBI,-11635500,DR,0.2587248495894128,62462000,10,4,14,0.0
2025-09-04,IKPM,90200,SH,0.1812248561418216,15910600,10,10,20,0.0
2025-09-04,IMAS,-2585000,AR,0.6080254043103426,229000000,10,10,20,0.0
2025-09-04,IMJS,-83562200,XL,0.21028912361409705,239235800,10,10,20,0.0
2025-09-04,IMPC,-6071558500,AZ,0.43476874584748654,22535069500,10,10,20,0.0
2025-09-04,INAI,0,OD,0.7647166218930127,5864000,6,4,10,0.0
2025-09-04,INCF,-16800,GR,0.8078491290096205,63659400,10,10,20,0.0
2025-09-04,INCI,0,XL,0.4514600165404924,35482500,7,6,13,0.0
2025-09-04,INCO,1635273000,BB,0.40508703311207706,7107969000,10,10,20,0.0
2025-09-04,INDF,-2917242500,YP,0.2328313131391322,2782230000,10,9,19,0.0
2025-09-04,INDO,-88198800,BR,0.2781430595577349,349420000,10,7,17,0.0
2025-09-04,INDR,0,GR,0.8077114615558741,107046000,8,6,14,0.0
2025-09-04,INDS,-200000,PD,0.2447551857415315,5800600,10,6,16,0.0
2025-09-04,INDX,-29474400,MU,0.1589364868247938,44250000,10,9,19,0.0
2025-09-04,INDY,-10945483500,YB,0.16099716695298055,6165214000,10,10,20,0.0
2025-09-04,INET,-420970400,XA,0.2543977574246143,1291909200,10,10,20,0.0
2025-09-04,INKP,-123660000,YP,0.21329405458207837,2462987500,10,10,20,0.0
2025-09-04,INOV,-10000,ZP,0.4999073775671005,19700000,10,8,18,0.0
2025-09-04,INPC,-50815600,EP,0.2213119758765111,188121000,10,10,20,0.0
2025-09-04,INPP,0,IF,0.5674854052890694,10547000,6,8,14,0.0
2025-09-04,INPS,0,YP,0.5559743539926171,5723200,6,4,10,0.0
2025-09-04,INRU,140000,CP,0.5576809897051589,92388500,8,10,18,0.0
2025-09-04,INTA,0,YJ,0.4883364319362839,134326800,10,10,20,0.0
2025-09-04,INTD,0,YP,0.8403555421538124,24524600,5,10,15,0.0
2025-09-04,INTP,139387500,CC,0.5294876876972109,2921905000,10,10,20,0.0
2025-09-04,IOTF,-268674100,PD,0.2184819922229363,592416500,10,10,20,0.0
2025-09-04,IPAC,0,XL,0.7277660259358043,791300,4,5,9,0.0
2025-09-04,IPCC,-9654500,BB,0.19325921254210152,323129500,10,10,20,0.0
2025-09-04,IPCM,0,PD,0.5823761862740545,300939400,10,10,20,0.0
2025-09-04,IPOL,0,XL,0.4758952713842907,1443200,6,1,7,0.0
2025-09-04,IPTV,-172200,EP,0.34706680540517737,98729400,10,8,18,0.0
2025-09-04,IRRA,0,IH,0.24133980800959953,51488400,9,10,19,0.0
2025-09-04,ISAP,2577600,RB,0.4933756943093648,82180800,7,10,17,0.0
2025-09-04,ISAT,195228000,CC,0.5776862601079643,4245577500,10,10,20,0.0
2025-09-04,ISEA,-160966600,YP,0.4702951977310445,988862200,10,10,20,0.0
2025-09-04,ISSP,-3539000,ZP,0.36515304521731695,251163000,10,10,20,0.0
2025-09-04,ITIC,-260000,YP,0.5334711036293189,69337800,10,3,13,0.0
2025-09-04,ITMA,-977000,ZP,0.31337233936493697,352047500,10,10,20,0.0
2025-09-04,ITMG,-816272500,CC,0.4532003391886955,5070615000,10,10,20,0.0
2025-09-04,JAST,-5962400,AO,0.4157961792679875,80250700,10,10,20,0.0
2025-09-04,JATI,6339500,XL,0.7004235898412496,105925900,7,10,17,0.0
2025-09-04,JAWA,-5379500,PD,0.27274723558195685,48192200,10,9,19,0.0
2025-09-04,JAYA,0,XL,0.4256986681037801,5529400,10,6,16,0.0
2025-09-04,JECC,-1186000,XL,0.44434767231088906,50253500,10,4,14,0.0
2025-09-04,JGLE,-14382400,XL,0.3008299897156597,166147200,10,4,14,0.0
2025-09-04,JIHD,-47534500,CC,0.41836883493798926,235258000,10,9,19,0.0
2025-09-04,JKON,-33420200,PD,0.3750763029735791,528183200,10,10,20,0.0
2025-09-04,JMAS,0,BR,0.14595966027644172,2980000,10,9,19,0.0
2025-09-04,JPFA,7449638500,ZP,0.38440114607000797,32545518500,10,10,20,0.0
2025-09-04,JRPT,0,PD,0.845721554721058,97066000,9,10,19,0.0
2025-09-04,JSMR,563183000,BB,0.5113159728070612,3233033000,10,10,20,0.0
2025-09-04,JSPT,0,MG,0.7867424915585569,13281000,5,4,9,0.0
2025-09-04,JTPE,-228000,IU,0.4996398464158614,65480400,10,10,20,0.0
2025-09-04,KAEF,-7681000,EP,0.2310674175962346,24350000,10,4,14,0.0
2025-09-04,KARW,-961500,CC,0.24108956772051288,19640000,10,7,17,0.0
2025-09-04,KBAG,0,NI,0.6768241679238058,73713800,10,10,20,0.0
2025-09-04,KBLI,0,TP,0.9954784867360927,8278200,2,7,9,0.0
2025-09-04,KBLM,0,YP,0.5989381532040153,58029800,5,10,15,0.0
2025-09-04,KBLV,-1723913800,XL,0.3209046863324624,1531549000,10,10,20,0.0
2025-09-04,KDSI,0,RF,0.9722454339262265,3257800,3,3,6,0.0
2025-09-04,KDTN,0,PD,0.43330980945659847,1166600,6,4,10,0.0
2025-09-04,KEEN,-21255000,CC,0.4115350557204676,480311000,10,10,20,0.0
2025-09-04,KEJU,-17122000,XC,0.2514377453513817,45732000,10,6,16,0.0
2025-09-04,KETR,-117976000,CC,0.5582082704960053,4341385000,10,10,20,0.0
2025-09-04,KICI,-313500,YP,0.5042270166208057,40020700,10,10,20,0.0
2025-09-04,KIJA,-293445900,EP,0.47879138277196787,16921827700,10,10,20,0.0
2025-09-04,KING,988800,IN,0.358614610228248,156868000,10,10,20,0.0
2025-09-04,KINO,1364500,LG,0.6853976238676563,50277000,10,10,20,0.0
2025-09-04,KIOS,-43088700,YP,0.4944880508107678,698318300,10,10,20,0.0
2025-09-04,KJEN,-397100,XC,0.38671996512086454,15788500,10,8,18,0.0
2025-09-04,KKES,0,YP,0.24987283670285648,10267000,10,5,15,0.0
2025-09-04,KKGI,-36328600,XL,0.40508520893007305,268901800,10,8,18,0.0
2025-09-04,KLAS,-932400,XA,0.4347277179451693,110568300,10,10,20,0.0
2025-09-04,KLBF,-7141079500,AG,0.43511609406947716,24904135500,10,10,20,0.0
2025-09-04,KLIN,0,YP,0.9729408584740796,36355200,5,5,10,0.0
2025-09-04,KMDS,0,GR,0.9648960263537163,196833000,7,6,13,0.0
2025-09-04,KMTR,-6951000,XL,0.2551542759207789,54310200,10,3,13,0.0
2025-09-04,KOBX,-28000,XL,0.3322228267959818,10440800,10,5,15,0.0
2025-09-04,KOCI,22980700,PD,0.22522294599798376,81812100,10,10,20,0.0
2025-09-04,KOIN,0,NI,0.7692307692307693,72000,3,2,5,0.0
2025-09-04,KOKA,-272100,PD,0.4081237572832034,116709600,10,10,20,0.0
2025-09-04,KONI,0,XL,0.5486975545229454,32354500,10,5,15,0.0
2025-09-04,KOPI,-33400,XC,0.597477234401349,8857600,10,8,18,0.0
2025-09-04,KOTA,7569000,MG,0.48729806997932473,295557000,8,10,18,0.0
2025-09-04,KPIG,151981500,EP,0.3704023467587762,4055039400,10,10,20,0.0
2025-09-04,KRAS,73380000,AT,0.3885212158863755,824756800,10,10,20,0.0
2025-09-04,KREN,-79928900,MG,0.42970983174434724,682854300,10,10,20,0.0
2025-09-04,KRYA,-13642000,XC,0.29455668769595705,146653000,10,10,20,0.0
2025-09-04,KUAS,11328300,XL,0.4359008951779741,105330700,10,10,20,0.0
2025-09-04,LABS,0,BR,0.3074205863099289,14229300,10,2,12,0.0
2025-09-04,LAJU,873411900,XL,0.3760164960439073,2196736500,10,10,20,0.0
2025-09-04,LAND,-560000,YP,0.8604848977632085,240865900,10,8,18,0.0
2025-09-04,LCKM,0,LG,0.42209831945971416,1075000,3,2,5,0.0
2025-09-04,LEAD,-34466800,XL,0.26206959956911774,201246600,10,10,20,0.0
2025-09-04,LFLO,0,XL,1.0,244000,1,1,2,0.0
2025-09-04,LINK,-364000,YP,0.4266884717713393,69924000,10,7,17,0.0
2025-09-04,LION,0,XC,0.47152944091171856,4567800,9,1,10,0.0
2025-09-04,LIVE,395200,BR,0.6121729277068726,216206500,10,10,20,0.0
2025-09-04,LMAX,-2069000,PD,0.47592424554606955,161228000,10,10,20,0.0
2025-09-04,LMPI,0,PD,0.5746764603008044,16430000,5,8,13,0.0
2025-09-04,LOPI,-628700,YP,0.42588126886129607,46217700,10,7,17,0.0
2025-09-04,LPCK,-11640000,PD,0.27903547551927665,203805000,10,6,16,0.0
2025-09-04,LPGI,-45800,YP,0.3625913379099377,12137600,10,6,16,0.0
2025-09-04,LPIN,-83600,XL,0.372209712296543,13322800,10,6,16,0.0
2025-09-04,LPKR,71337300,TP,0.21485091243728674,707505000,10,10,20,0.0
2025-09-04,LPLI,-408200,LG,0.5924518658608203,144666200,10,6,16,0.0
2025-09-04,LPPF,37235500,LG,0.6512858619993187,648139500,10,10,20,0.0
2025-09-04,LPPS,-1473600,YP,0.25996188149567745,49375600,10,10,20,0.0
2025-09-04,LRNA,0,PD,0.38547237076648844,346000,6,4,10,0.0
2025-09-04,LSIP,-482964000,BB,0.3238892878919109,1083907000,10,10,20,0.0
2025-09-04,LTLS,0,CC,0.5992171821048826,24035500,6,6,12,0.0
2025-09-04,LUCK,-374000,YP,0.2335373132598542,20150300,10,9,19,0.0
2025-09-04,LUCY,0,XC,0.18910175553148234,12743000,10,9,19,0.0
2025-09-04,MAHA,-95600,XC,0.465861780546229,74467400,10,10,20,0.0
2025-09-04,MAIN,209282500,AZ,0.42505752091802157,984943500,10,10,20,0.0
2025-09-04,MANG,34777900,XC,0.3687910770204328,232879100,10,10,20,0.0
2025-09-04,MAPA,277648500,CC,0.7373853619289468,3666003500,10,10,20,0.0
2025-09-04,MAPB,0,AT,0.9250864387245485,8428000,4,5,9,0.0
2025-09-04,MAPI,-186211000,YU,0.35548275385243533,1521888500,10,10,20,0.0
2025-09-04,MARI,336600,CC,0.2804587085353652,12389600,9,10,19,0.0
2025-09-04,MARK,2757000,XC,0.7589739319442043,888665500,10,10,20,0.0
2025-09-04,MASB,0,MG,0.7995079950799509,1300000,2,1,3,0.0
2025-09-04,MAXI,-15677100,YP,0.34729360747856824,429909200,10,10,20,0.0
2025-09-04,MAYA,-13244800,NI,0.34307999543556916,362590200,10,10,20,0.0
2025-09-04,MBAP,-325000,KK,0.193829097227596,13776500,10,6,16,0.0
2025-09-04,MBMA,2681425200,YU,0.47501225500224636,15951183800,10,10,20,0.0
2025-09-04,MBSS,-187265000,KK,0.2560958651776298,425428500,10,10,20,0.0
2025-09-04,MBTO,0,XL,0.504196357100413,10266900,9,10,19,0.0
2025-09-04,MCAS,0,XC,0.38559151543913583,18687500,10,5,15,0.0
2025-09-04,MCOL,0,SQ,0.37513943213977796,77015000,9,4,13,0.0
2025-09-04,MCOR,-1632000,GR,0.41201136863101423,41807700,10,10,20,0.0
2025-09-04,MDIA,410700,XL,0.28180073726203103,41295700,4,10,14,0.0
2025-09-04,MDIY,-4072500,YU,0.6984597210911584,607232500,10,8,18,0.0
2025-09-04,MDKA,10041787000,YB,0.317523239226934,26733470000,10,10,20,0.0
2025-09-04,MDKI,-63500,BQ,0.21012841091492776,9163700,10,4,14,0.0
2025-09-04,MDLN,-66453400,YP,0.26646126566442485,449496600,10,10,20,0.0
2025-09-04,MDRN,571600,YB,0.39040260376952224,263266200,10,10,20,0.0
2025-09-04,MEDC,1560418500,ZP,0.6215820626684903,11031874500,10,10,20,0.0
2025-09-04,MEDS,-635744300,BQ,0.22120920749442294,1228131200,10,10,20,0.0
2025-09-04,MEGA,0,XA,0.309506080913378,13717000,9,2,11,0.0
2025-09-04,MEJA,53057000,KK,0.22653276844662337,630280400,10,10,20,0.0
2025-09-04,MENN,-97636300,PD,0.26258750845987594,253590000,10,10,20,0.0
2025-09-04,MERK,0,NI,0.5735963581183612,9828000,7,7,14,0.0
2025-09-04,MFIN,-2202500,YP,0.7119229910688603,154682000,10,10,20,0.0
2025-09-04,MGNA,0,MG,0.5695626527344737,28387800,3,9,12,0.0
2025-09-04,MGRO,5946500,XA,0.260012310293556,210370500,10,10,20,0.0
2025-09-04,MHKI,34020300,YP,0.4991609746726277,717128100,10,10,20,0.0
2025-09-04,MICE,0,YB,0.6672301054223566,3000000,5,5,10,0.0
2025-09-04,MIDI,-11135800,YU,0.5603232967446166,929872200,10,10,20,0.0
2025-09-04,MIKA,872380000,CC,0.7234044994236042,9205778000,10,10,20,0.0
2025-09-04,MINA,-166986500,XL,0.48465337450302043,3988071100,10,10,20,0.0
2025-09-04,MITI,-5949600,IF,0.5057673998382715,297590200,10,10,20,0.0
2025-09-04,MKAP,984200,ZP,0.3326105332794296,7240000,7,10,17,0.0
2025-09-04,MKPI,0,XL,0.7021820917983446,11665000,2,3,5,0.0
2025-09-04,MKTR,-16057300,CP,0.7549234693407177,696022000,10,10,20,0.0
2025-09-04,MLBI,-4105000,GR,0.5202389241372836,332492500,10,5,15,0.0
2025-09-04,MLIA,-13994000,MI,0.1675098674882548,109282600,10,10,20,0.0
2025-09-04,MLPL,-317206300,ZP,0.23203463289748366,512221000,10,10,20,0.0
2025-09-04,MLPT,0,YU,0.9798358749042696,2651600000,5,10,15,0.0
2025-09-04,MMIX,88361600,LG,0.5784544683833756,375000000,10,10,20,0.0
2025-09-04,MMLP,8919500,RF,0.26330160711499456,324000000,10,10,20,0.0
2025-09-04,MNCN,209319200,CC,0.329507415902304,1079910800,10,10,20,0.0
2025-09-04,MOLI,-8151600,XL,0.3308511951289752,117413200,10,6,16,0.0
2025-09-04,MORA,-95200,XC,0.37416433693934603,4925200,10,6,16,0.0
2025-09-04,MPIX,-10692200,AZ,0.4202349372800043,243347000,10,10,20,0.0
2025-09-04,MPMX,4221500,XL,0.5920359959168443,383946000,10,10,20,0.0
2025-09-04,MPOW,-81900,CC,0.274270565922066,11453100,10,8,18,0.0
2025-09-04,MPPA,-128670100,ZP,0.33997571096849216,384052100,10,10,20,0.0
2025-09-04,MPRO,0,AN,0.8186433354936271,121264000,8,7,15,0.0
2025-09-04,MPXL,37389400,GR,0.9345279939327522,436701100,9,10,19,0.0
2025-09-04,MRAT,0,DR,0.3684356391146399,9837600,10,7,17,0.0
2025-09-04,MREI,0,ZP,0.829104761455474,140600000,8,4,12,0.0
2025-09-04,MSIE,26800,BQ,0.47137857195599203,63838800,10,10,20,0.0
2025-09-04,MSIN,3371091500,YU,0.6738058570864223,18853366500,10,10,20,0.0
2025-09-04,MSJA,0,AZ,0.8626322128196049,140816600,10,7,17,0.0
2025-09-04,MSKY,837650900,MG,0.4211802969610874,2315340000,10,10,20,0.0
2025-09-04,MSTI,-80569500,DX,0.5858771014197578,655861000,10,10,20,0.0
2025-09-04,MTDL,107318500,YU,0.49373810386466616,656153500,10,10,20,0.0
2025-09-04,MTEL,-19280500,ZP,0.5225637028767229,409326500,10,10,20,0.0
2025-09-04,MTFN,-58994600,XL,0.3948091766669988,660171400,10,4,14,0.0
2025-09-04,MTLA,0,LG,0.4598626932075327,4796000,5,3,8,0.0
2025-09-04,MTMH,-6699500,SQ,0.41711346718935716,562545500,10,3,13,0.0
2025-09-04,MTPS,-41700,XL,0.48516248533219547,10005700,10,2,12,0.0
2025-09-04,MTWI,0,MG,0.7592088164734107,24304400,2,9,11,0.0
2025-09-04,MUTU,19591300,IF,0.5025844666914644,248748000,9,10,19,0.0
2025-09-04,MYOH,0,TP,0.3759356433981897,16800000,10,6,16,0.0
2025-09-04,MYOR,-68086000,ZP,0.4678960121650724,1805264000,10,10,20,0.0
2025-09-04,NAIK,9853400,SQ,0.6603685164601991,429792000,10,10,20,0.0
2025-09-04,NANO,20712600,SQ,0.4104985361428395,294668000,6,10,16,0.0
2025-09-04,NASA,180000,XL,0.8124238666267039,59091000,7,10,17,0.0
2025-09-04,NASI,3937700,CC,0.3297567090821692,31144400,10,10,20,0.0
2025-09-04,NATO,0,YP,0.38208722894889807,3878300,8,6,14,0.0
2025-09-04,NAYZ,-2560500,XA,0.6058890396331387,515097900,10,10,20,0.0
2025-09-04,NCKL,-1697943000,KK,0.25617594842800867,5396326500,10,10,20,0.0
2025-09-04,NELY,-390600,MG,0.2998473964342874,40280000,10,10,20,0.0
2025-09-04,NEST,-11446200,AZ,0.41217896962342315,456701800,10,10,20,0.0
2025-09-04,NETV,-133000,XC,0.4355558850500553,65213300,10,9,19,0.0
2025-09-04,NFCX,0,PG,0.7849424622185961,41370000,3,4,7,0.0
2025-09-04,NICE,-31776200,XL,0.2930408924861889,241024200,10,10,20,0.0
2025-09-04,NICK,0,CC,0.6734276361935937,5760500,3,6,9,0.0
2025-09-04,NICL,228809000,CC,0.3103197721638469,2101449500,10,10,20,0.0
2025-09-04,NIKL,-1083200,EP,0.42565538336303704,69023000,10,7,17,0.0
2025-09-04,NIRO,0,XC,0.6606132274685362,7038900,3,3,6,0.0
2025-09-04,NISP,3179000,ZP,0.3630751146612685,720300000,10,10,20,0.0
2025-09-04,NOBU,-60229000,XL,0.35628283690116985,516124500,10,10,20,0.0
2025-09-04,NPGF,-3488400,XL,0.8082451831646204,2958203800,10,10,20,0.0
2025-09-04,NRCA,-450555500,ZP,0.26780837447268596,965021500,10,10,20,0.0
2025-09-04,NSSS,-376015800,XL,0.2332729814991478,633663800,10,6,16,0.0
2025-09-04,NTBK,-63094700,XL,0.3293324702262692,613405800,10,10,20,0.0
2025-09-04,NZIA,0,YP,0.20653351840664788,4478700,9,7,16,0.0
2025-09-04,OASA,-1737841800,HP,0.37929658346480194,11584774000,10,10,20,0.0
2025-09-04,OBMD,-178600,XL,0.26800559870925356,88768600,10,9,19,0.0
2025-09-04,OILS,84600,ES,0.5570551834780616,70000000,9,10,19,0.0
2025-09-04,OKAS,-9306400,AO,0.31578489367313456,165476400,10,10,20,0.0
2025-09-04,OLIV,828000,PG,1.0,91663200,1,10,11,0.0
2025-09-04,OMED,0,DR,0.7665454983489931,21635900,5,10,15,0.0
2025-09-04,OPMS,-5037700,YP,0.4677596095541069,99588500,10,10,20,0.0
2025-09-04,PACK,-767977000,SQ,0.2315049420827551,2043552000,10,10,20,0.0
2025-09-04,PADA,-7976500,YP,0.30685266393075944,248653300,10,10,20,0.0
2025-09-04,PADI,6018000,YB,0.839394924573554,690138000,10,10,20,0.0
2025-09-04,PALM,-31945200,LG,0.39513298869285474,378424000,10,10,20,0.0
2025-09-04,PAMG,-34387000,PD,0.2908651485808918,203210900,10,10,20,0.0
2025-09-04,PANI,-409797500,XL,0.36395714663166423,13929927500,10,10,20,0.0
2025-09-04,PANR,-44158000,FZ,0.26033214707383273,310677000,10,10,20,0.0
2025-09-04,PANS,-5257000,YP,0.23546421147581204,96454500,10,5,15,0.0
2025-09-04,PART,-359500,KI,0.8352929377541805,4089392500,10,10,20,0.0
2025-09-04,PBID,49000,XL,0.5028216745865105,54600400,6,10,16,0.0
2025-09-04,PBRX,-17152800,XL,0.2949123527225694,1001076000,10,10,20,0.0
2025-09-04,PBSA,38795500,AK,0.3604582307507524,687247500,9,10,19,0.0
2025-09-04,PCAR,-8200,XL,0.34988696234132294,64723000,10,9,19,0.0
2025-09-04,PDES,0,SH,1.0,143400,1,1,2,0.0
2025-09-04,PDPP,0,PD,0.7493913763440043,177582600,10,6,16,0.0
2025-09-04,PEGE,4592400,XL,0.25826856383297014,50498400,9,10,19,0.0
2025-09-04,PEHA,0,XC,0.3929226736566186,299800,4,5,9,0.0
2025-09-04,PEVE,-50000,PO,0.27010203782341036,16576000,10,10,20,0.0
2025-09-04,PGAS,3850388000,SS,0.4372120546660212,17249003000,10,10,20,0.0
2025-09-04,PGEO,-1600816500,DR,0.44145453890477626,8798765500,10,10,20,0.0
2025-09-04,PGLI,0,EP,0.7276468387579499,5057000,4,8,12,0.0
2025-09-04,PICO,-735000,KK,0.33288482324264873,21004300,10,5,15,0.0
2025-09-04,PIPA,88049300,XL,0.4840846287208662,2875029100,10,10,20,0.0
2025-09-04,PJAA,0,YP,0.6374053162804945,16855100,8,7,15,0.0
2025-09-04,PKPK,0,PD,0.7247385728378822,110196500,9,7,16,0.0
2025-09-04,PLAN,-2501400,XL,0.49035792486336444,227530000,10,9,19,0.0
2025-09-04,PMJS,0,XC,0.5269129341537707,12887500,8,7,15,0.0
2025-09-04,PNBN,13327500,DP,0.5938881373733536,2613545500,10,10,20,0.0
2025-09-04,PNBS,-18471800,GR,0.1988334217724154,165359000,10,10,20,0.0
2025-09-04,PNGO,0,CC,0.8945511157239232,8619000,2,7,9,0.0
2025-09-04,PNIN,-1096500,YP,0.45489882392246433,141605000,10,6,16,0.0
2025-09-04,PNLF,-1216962400,GR,0.22296177782804036,1766489600,10,10,20,0.0
2025-09-04,PNSE,-587500,XL,0.47199117550606684,23748000,10,4,14,0.0
2025-09-04,POLA,-77468200,DR,0.27555002112255517,361485200,10,4,14,0.0
2025-09-04,POLI,0,CC,0.7994825355756792,309000,2,2,4,0.0
2025-09-04,POLU,765000,NI,0.4611758078026434,155535000,10,10,20,0.0
2025-09-04,POLY,0,XL,0.6977486350841908,15195500,7,9,16,0.0
2025-09-04,PORT,0,AI,0.9697087980836069,90676500,4,7,11,0.0
2025-09-04,POWR,-58284000,XL,0.30135128333020644,329276000,10,9,19,0.0
2025-09-04,PPGL,0,LG,0.6812131238868584,16140800,8,5,13,0.0
2025-09-04,PPRE,-213242400,GR,0.41905499846706434,1484249600,10,10,20,0.0
2025-09-04,PPRI,79381400,GR,0.26664918985158625,734385200,10,10,20,0.0
2025-09-04,PRAY,0,XL,0.3467650016761649,2586000,6,5,11,0.0
2025-09-04,PRDA,0,XL,0.49379357252168,23232000,7,7,14,0.0
2025-09-04,PRIM,-30941700,YP,0.4512423278224967,408362800,10,10,20,0.0
2025-09-04,PSAB,-6406142500,XL,0.2091661165446968,7119893500,10,10,20,0.0
2025-09-04,PSDN,6445900,CP,0.6990739652091617,264588800,7,10,17,0.0
2025-09-04,PSGO,0,OD,0.3715600101648803,19885000,9,4,13,0.0
2025-09-04,PSKT,17808000,ES,0.8299154208728867,1323188100,10,10,20,0.0
2025-09-04,PSSI,0,XC,0.5276999377698995,27983400,7,9,16,0.0
2025-09-04,PTBA,-3623747000,CC,0.1571663586092539,2582813000,10,9,19,0.0
2025-09-04,PTIS,0,YP,0.7504218519299726,8538600,5,6,11,0.0
2025-09-04,PTMP,-53296900,XC,0.27591637699114985,84828200,10,10,20,0.0
2025-09-04,PTPP,498709600,ZP,0.350190389439225,1236696800,10,10,20,0.0
2025-09-04,PTPS,-33800300,YP,0.30093893433500307,264040300,10,10,20,0.0
2025-09-04,PTPW,0,IH,0.22141353014536014,5415000,8,4,12,0.0
2025-09-04,PTRO,-986311000,AZ,0.2304621775236489,7153481000,10,10,20,0.0
2025-09-04,PTSN,-48401600,OD,0.18254220930174397,156929000,10,10,20,0.0
2025-09-04,PTSP,-8426500,XL,0.44020673506244395,253134500,10,9,19,0.0
2025-09-04,PUDP,0,XL,0.5072244682721041,2885600,4,3,7,0.0
2025-09-04,PURA,3447000,BR,0.32890023284972236,88140000,8,10,18,0.0
2025-09-04,PURI,0,XL,0.6706700038186316,32316100,8,8,16,0.0
2025-09-04,PWON,801657600,CC,0.6758752570990335,7251096200,10,10,20,0.0
2025-09-04,PYFA,-2050762000,XL,0.43418664524699957,10746050000,10,10,20,0.0
2025-09-04,PZZA,-51023600,YP,0.19739991089890388,133902400,10,10,20,0.0
2025-09-04,RAAM,-1469800,NI,0.2570436475088284,142840800,10,10,20,0.0
2025-09-04,RAJA,14248436000,ES,0.6891018821823649,51329821000,10,10,20,0.0
2025-09-04,RALS,8322600,SQ,0.4697183158749674,285929000,10,10,20,0.0
2025-09-04,RANC,0,SQ,0.591552362290442,543400,4,4,8,0.0
2025-09-04,RBMS,-3400,DR,0.45603794235680406,17000000,10,5,15,0.0
2025-09-04,RCCC,-127400,XA,0.29468761218438794,8865500,10,6,16,0.0
2025-09-04,RDTX,0,XC,0.8318980365139511,6037500,2,3,5,0.0
2025-09-04,REAL,46011100,XL,0.367746623600703,344640000,10,10,20,0.0
2025-09-04,RELF,5812800,AO,0.6513421465766469,364440000,4,10,14,0.0
2025-09-04,RELI,0,XC,0.48799747315224257,6180000,3,4,7,0.0
2025-09-04,RGAS,-195065100,GR,0.24869387700115336,596271200,10,9,19,0.0
2025-09-04,RICY,2450700,OD,0.41520845718421256,101203200,7,10,17,0.0
2025-09-04,RIGS,-1110000,ZP,0.3007690907354036,83435000,10,6,16,0.0
2025-09-04,RISE,-3549500,SH,0.31815072856386084,94891000,10,8,18,0.0
2025-09-04,RMKE,-256554000,ZP,0.2841784852849215,456484000,10,10,20,0.0
2025-09-04,RMKO,-23944500,CP,0.4378168042702458,250051800,10,10,20,0.0
2025-09-04,ROCK,0,DX,1.0,62500,1,1,2,0.0
2025-09-04,RODA,0,YP,0.4972562262558041,5418800,4,3,7,0.0
2025-09-04,ROTI,0,CD,0.518026377650756,62805000,8,7,15,0.0
2025-09-04,RSCH,-10563200,ZP,0.6186215031658756,1621141200,10,10,20,0.0
2025-09-04,RUIS,-5738200,YP,0.23187585918508377,81402200,10,10,20,0.0
2025-09-04,RUNS,-745600,LG,0.2774239932940001,43024300,10,8,18,0.0
2025-09-04,SAFE,0,YJ,0.5968961384549757,14692300,8,8,16,0.0
2025-09-04,SAGE,1705500,YB,0.5918969379799406,65972300,10,10,20,0.0
2025-09-04,SAME,-13542800,YP,0.48544981251667857,269960000,10,8,18,0.0
2025-09-04,SAMF,-300600,SQ,0.3410511602624665,5270400,10,4,14,0.0
2025-09-04,SAPX,-30400,OD,0.31373134121206653,9041800,10,8,18,0.0
2025-09-04,SATU,442800,BR,0.5737069305277995,123730800,6,10,16,0.0
2025-09-04,SBMA,0,YP,0.4235067880080429,137137300,10,10,20,0.0
2025-09-04,SCCO,0,YP,0.469198105503838,28729000,8,7,15,0.0
2025-09-04,SCMA,993535600,YU,0.28219692558454557,5636339400,10,10,20,0.0
2025-09-04,SCNP,0,YP,0.5279254506568897,1727900,5,2,7,0.0
2025-09-04,SDMU,-4075500,XL,0.31405786070368163,251900000,10,10,20,0.0
2025-09-04,SDPC,0,CC,0.3107401010034495,6134600,8,4,12,0.0
2025-09-04,SDRA,0,GR,0.38826945212775094,4520000,5,6,11,0.0
2025-09-04,SEMA,-90800,CP,0.8482233164803836,126213000,10,10,20,0.0
2025-09-04,SFAN,0,IH,0.3636395604395604,20682000,5,8,13,0.0
2025-09-04,SGER,10714800,RO,0.3442320762786943,3359842000,10,10,20,0.0
2025-09-04,SGRO,-20743000,BB,0.22583863091487744,531567000,10,10,20,0.0
2025-09-04,SHID,0,KK,0.7692307692307693,905000,3,4,7,0.0
2025-09-04,SHIP,936000,YP,0.7731533113447073,97749000,8,10,18,0.0
2025-09-04,SICO,-135700,XC,0.36220471761748757,41990900,10,4,14,0.0
2025-09-04,SIDO,110061500,BB,0.3166420547623404,1066863500,10,10,20,0.0
2025-09-04,SILO,39086000,AK,0.520727489778915,376876000,5,10,15,0.0
2025-09-04,SIMP,528501500,RF,0.321641641323414,2994750000,10,10,20,0.0
2025-09-04,SINI,0,NI,0.5194918267102963,71600000,4,6,10,0.0
2025-09-04,SIPD,0,XL,0.6666666666666666,147000,2,1,3,0.0
2025-09-04,SKBM,0,XL,0.5101430706811872,477800,4,1,5,0.0
2025-09-04,SKLT,0,KK,0.7856221065075941,17410800,3,10,13,0.0
2025-09-04,SKRN,-5601200,XL,0.4580484756799421,208918200,10,3,13,0.0
2025-09-04,SLIS,-197002600,DR,0.3327244469062728,2385607500,10,10,20,0.0
2025-09-04,SMAR,-22380000,XL,0.30700413213930705,172182500,10,8,18,0.0
2025-09-04,SMBR,-487045600,ZP,0.21748748423100375,760116800,10,10,20,0.0
2025-09-04,SMDM,0,DH,0.3094745908699397,7186000,9,8,17,0.0
2025-09-04,SMDR,-227233600,NI,0.23204398196960063,433787800,10,10,20,0.0
2025-09-04,SMGA,-485445900,ZP,0.21259060411572786,1149359600,10,10,20,0.0
2025-09-04,SMGR,331521000,CC,0.6303979704175979,3807269000,10,10,20,0.0
2025-09-04,SMIL,4251525300,AK,0.4434008163587812,12992147800,10,10,20,0.0
2025-09-04,SMKL,0,XC,0.4611349755997779,6312200,6,7,13,0.0
2025-09-04,SMLE,0,PD,0.3555926414453822,13722000,10,7,17,0.0
2025-09-04,SMMA,-8015000,YU,0.23112346289253613,114557500,10,10,20,0.0
2025-09-04,SMMT,73160000,PD,0.7485479567944587,651222500,10,10,20,0.0
2025-09-04,SMRA,58244200,YP,0.33900349115415357,1514524200,10,10,20,0.0
2025-09-04,SMSM,2138000,DR,0.4581813405367071,388932500,10,10,20,0.0
2025-09-04,SNLK,27030200,CC,0.21363870147438724,153440400,10,10,20,0.0
2025-09-04,SOCI,-3234200,XA,0.3902915600866711,178810400,10,10,20,0.0
2025-09-04,SOFA,33712600,YP,0.5991895217349406,182179200,6,10,16,0.0
2025-09-04,SOHO,0,EP,0.7225743539736714,2964000,5,4,9,0.0
2025-09-04,SOLA,8022600,GR,0.28359923857847796,284738400,10,10,20,0.0
2025-09-04,SONA,6060000,YB,0.60073992544733,429004000,10,10,20,0.0
2025-09-04,SOTS,0,YP,1.0,383400,1,4,5,0.0
2025-09-04,SOUL,1358800,TP,0.4759151767727435,88000000,7,10,17,0.0
2025-09-04,SPMA,0,AT,0.3607698289269051,9279000,9,5,14,0.0
2025-09-04,SPRE,-9513300,KK,0.2526206908037413,69775300,10,9,19,0.0
2025-09-04,SPTO,0,XC,0.631745033080031,64263000,8,8,16,0.0
2025-09-04,SRAJ,30910000,FZ,0.3524146267898909,1107085000,10,10,20,0.0
2025-09-04,SRSN,-12827200,YP,0.36084867136694965,371805300,10,10,20,0.0
2025-09-04,SRTG,1874362000,GR,0.321866176713195,8677197500,10,10,20,0.0
2025-09-04,SSIA,-3262547000,YU,0.3619540935722772,6949334000,10,10,20,0.0
2025-09-04,SSMS,-275462500,PD,0.30104126176891793,570403500,10,10,20,0.0
2025-09-04,SSTM,-21461600,XL,0.5041347619794837,330273000,10,10,20,0.0
2025-09-04,STAA,-71609000,IF,0.27844523349412503,825912000,10,10,20,0.0
2025-09-04,STAR,0,CC,0.4977640178878569,6800900,6,2,8,0.0
2025-09-04,STRK,259744400,AK,0.42207228638362004,1917447300,10,10,20,0.0
2025-09-04,STTP,0,NI,0.7692307692307693,20750000,3,1,4,0.0
2025-09-04,SULI,0,YJ,0.3681947259173802,24000000,6,8,14,0.0
2025-09-04,SUNI,1766000,AI,0.22429125454709437,55954500,10,10,20,0.0
2025-09-04,SURE,0,CP,0.36258602711157456,8693000,9,5,14,0.0
2025-09-04,SURI,289515000,YP,0.5059007705195685,1575520800,10,10,20,0.0
2025-09-04,SWID,-901400,DH,0.2553863702733903,26060800,10,9,19,0.0
2025-09-04,TALF,0,CP,0.3361883153715258,5927000,9,2,11,0.0
2025-09-04,TAMA,0,XL,0.7289352247479064,15354000,6,9,15,0.0
2025-09-04,TAMU,-14789200,XL,0.311019260140213,143729900,10,10,20,0.0
2025-09-04,TAPG,-292688000,ZP,0.2879007980812857,2695837000,10,10,20,0.0
2025-09-04,TARA,712800,OD,0.8285038438793614,60102900,3,10,13,0.0
2025-09-04,TAXI,-151762500,XL,0.2085881427485233,288684300,10,10,20,0.0
2025-09-04,TAYS,-24161400,AI,0.19906572851854004,113997000,10,10,20,0.0
2025-09-04,TBIG,29615000,AK,0.843038455051442,1159623000,9,10,19,0.0
2025-09-04,TBLA,1432500,NI,0.5437343668854223,262270000,10,10,20,0.0
2025-09-04,TBMS,0,PD,0.8139180692779319,41684000,4,5,9,0.0
2025-09-04,TCID,0,CP,0.895057477353393,16896000,4,2,6,0.0
2025-09-04,TCPI,10692500,AK,0.49229254217401197,1644710000,8,10,18,0.0
2025-09-04,TEBE,-345108000,NI,0.5213222387963135,3496991000,10,10,20,0.0
2025-09-04,TFAS,5076600,PG,0.5411507860548321,85094500,7,10,17,0.0
2025-09-04,TGKA,0,OD,1.0,577500,1,1,2,0.0
2025-09-04,TIFA,0,YP,0.5792222491713154,7164400,5,4,9,0.0
2025-09-04,TINS,-2675609500,YP,0.34262417454506483,2762208000,10,10,20,0.0
2025-09-04,TIRA,0,PD,0.4384958797268444,12425000,8,4,12,0.0
2025-09-04,TKIM,-24635000,MG,0.34024402230952405,2682662500,10,10,20,0.0
2025-09-04,TLDN,-80657500,XL,0.36992996477592077,474804000,10,10,20,0.0
2025-09-04,TLKM,3488187000,BB,0.3983951117503641,16244432000,10,10,20,0.0
2025-09-04,TMAS,6591800,YP,0.29020934919531655,75698700,10,10,20,0.0
2025-09-04,TMPO,-92936200,XL,0.38226200873869387,921992800,10,9,19,0.0
2025-09-04,TNCA,2404900,CC,0.5105380827825146,42999100,10,10,20,0.0
2025-09-04,TOBA,-1039830000,XL,0.2502502455671362,3717569500,10,10,20,0.0
2025-09-04,TOOL,-16639100,XL,0.39927324455523744,180925600,10,10,20,0.0
2025-09-04,TOSK,-3193400,XC,0.2167834209708107,405371600,10,10,20,0.0
2025-09-04,TOTL,-22463000,KK,0.42810897060577774,391185000,10,10,20,0.0
2025-09-04,TOTO,-229600,PD,0.4874988484834527,67736600,10,10,20,0.0
2025-09-04,TOWR,-1092941500,CC,0.6574130360362754,8644680000,10,10,20,0.0
2025-09-04,TPIA,1107337500,OD,0.3748472033046636,5836415000,10,10,20,0.0
2025-09-04,TPMA,-35962500,YP,0.43201335285795833,452562500,10,10,20,0.0
2025-09-04,TRGU,-86500,MG,0.44538767144008123,14428200,10,5,15,0.0
2025-09-04,TRIM,-416000,RF,0.7947622201067837,230427000,10,10,20,0.0
2025-09-04,TRIN,-1841800,YJ,0.32727259861519464,37000000,10,9,19,0.0
2025-09-04,TRIS,0,XL,0.6729131269904183,24278100,9,9,18,0.0
2025-09-04,TRJA,0,CC,0.7372046852567742,40771400,7,6,13,0.0
2025-09-04,TRON,-34316900,XL,0.38870319978587625,237008200,10,4,14,0.0
2025-09-04,TRST,0,AZ,0.9901939884885952,14864000,3,3,6,0.0
2025-09-04,TRUE,3083200,PD,0.40898367412197334,92088400,10,10,20,0.0
2025-09-04,TRUK,8164900,LG,0.7396343922540887,226312000,5,10,15,0.0
2025-09-04,TRUS,0,XL,1.0,4343600,1,2,3,0.0
2025-09-04,TSPC,2488000,PD,0.31135960525665646,182741000,7,10,17,0.0
2025-09-04,TUGU,6848500,CC,0.4001461241856988,624628500,10,10,20,0.0
2025-09-04,TYRE,0,XL,0.5896501542581059,20259200,9,6,15,0.0
2025-09-04,UANG,0,PD,0.2857966834895458,153605000,10,10,20,0.0
2025-09-04,UCID,-18543600,YU,0.5229195589480301,1227921800,10,10,20,0.0
2025-09-04,UFOE,0,DH,0.9006571318129107,8155000,5,3,8,0.0
2025-09-04,ULTJ,-24196500,AH,0.46913993669321724,706080000,10,8,18,0.0
2025-09-04,UNIC,0,CC,0.8438026474127557,8765000,3,4,7,0.0
2025-09-04,UNIQ,-578283600,XC,0.22562269869901047,1522925600,10,10,20,0.0
2025-09-04,UNSP,0,CC,0.6944655618062947,36540000,8,4,12,0.0
2025-09-04,UNTD,-35182500,XL,0.14489249568233625,30898600,10,10,20,0.0
2025-09-04,UNTR,-2368825000,YU,0.6377725536624178,21407827500,10,10,20,0.0
2025-09-04,UNVR,-1766945500,ZP,0.2917485946064722,5707900500,10,9,19,0.0
2025-09-04,URBN,-196200,YP,0.4652425267907501,15837600,10,4,14,0.0
2025-09-04,UVCR,21494400,YB,0.6303708365299968,320937300,10,10,20,0.0
2025-09-04,VAST,-847400,HD,0.24740537378683616,87467300,10,10,20,0.0
2025-09-04,VERN,-9420100,XC,0.3863954995174209,100486400,10,10,20,0.0
2025-09-04,VICI,-241500,CP,0.24555264772178687,33825000,10,10,20,0.0
2025-09-04,VICO,-52500,PD,0.6428747763124479,54426100,10,9,19,0.0
2025-09-04,VINS,0,CC,0.7590944322438962,11752300,7,10,17,0.0
2025-09-04,VISI,16005500,XL,0.2713458544877289,176247300,10,10,20,0.0
2025-09-04,VIVA,13440200,XL,0.4104900278825122,431976800,10,10,20,0.0
2025-09-04,VKTR,-103075300,KI,0.3084609042268728,622642000,10,10,20,0.0
2025-09-04,VOKS,0,XL,0.4802742589986089,11669800,9,9,18,0.0
2025-09-04,VRNA,-137000,XL,0.32740517214013215,17533300,10,8,18,0.0
2025-09-04,VTNY,-61032700,EP,0.14341789852655376,119873900,10,10,20,0.0
2025-09-04,WAPO,-27012900,BQ,0.3013263984670036,489419700,10,10,20,0.0
2025-09-04,WEGE,-527882100,AO,0.3612255244217634,3693150400,10,10,20,0.0
2025-09-04,WEHA,-3080600,PD,0.2235265571922794,14279100,10,7,17,0.0
2025-09-04,WGSH,0,ZP,0.9052263920778268,132903800,5,8,13,0.0
2025-09-04,WIDI,2871000,DH,0.41574398826307224,199496000,8,10,18,0.0
2025-09-04,WIFI,2635087000,YU,0.42575772532405154,20991607000,10,10,20,0.0
2025-09-04,WIIM,-4209000,XL,0.2701240529204632,94318000,10,7,17,0.0
2025-09-04,WINE,0,YJ,0.613195977434388,43000000,5,10,15,0.0
2025-09-04,WINR,-14038200,CC,0.427658040990263,165726600,10,8,18,0.0
2025-09-04,WINS,-11219400,DX,0.5858095437271583,405600000,10,10,20,0.0
2025-09-04,WIRG,4201417700,XA,0.190023761114371,3673964300,10,10,20,0.0
2025-09-04,WMUU,-27190900,XL,0.32298165199637635,238874000,10,10,20,0.0
2025-09-04,WOMF,0,ZP,0.2637699087675893,3411600,10,7,17,0.0
2025-09-04,WOOD,-7572000,YP,0.45937105189499194,419813600,10,10,20,0.0
2025-09-04,WOWS,-556032300,YP,0.27485992425255845,1766217000,10,10,20,0.0
2025-09-04,WSBP,-554172300,XL,0.5099698102159136,4264976100,10,10,20,0.0
2025-09-04,WTON,412108300,SQ,0.33655590707765315,876905200,10,10,20,0.0
2025-09-04,YELO,-5824700,CC,0.413113703508936,53890600,10,8,18,0.0
2025-09-04,YULE,0,RB,1.0,1350000,1,2,3,0.0
2025-09-04,ZATA,210600,OD,0.3169230002243438,66112800,10,10,20,0.0
2025-09-04,ZINC,-18722000,XL,0.2178088779542651,68752200,10,10,20,0.0
2025-09-04,ZONE,0,AR,0.33722467817000923,26012500,8,7,15,0.0
2025-09-04,ZYRX,2544600,YP,0.4310595264848573,81520900,10,10,20,0.0
